一	一
乙	乙
二	二
十	十
丁	丁
厂	厂
七	七
卜	卜
八	八
人	人
入	入
儿	儿
匕	匕
几	几
九	九
刁	刁
了	了
刀	刀
力	力
乃	乃
又	又
三	三
干	干
于	于
亏	亏
工	工
土	土
士	士
才	才
下	下
寸	寸
大	大
丈	丈
与	与
万	万
上	上
小	小
口	口
山	山
巾	巾
千	千
乞	乞
川	川
亿	亿
个	个
夕	夕
久	久
么	么
勺	勺
凡	凡
丸	丸
及	及
广	广
亡	亡
门	门
丫	丫
义	义
之	之
尸	尸
己	己
已	已
巳	巳
弓	弓
子	子
卫	卫
也	也
女	女
刃	刃
飞	飞
习	习
叉	叉
马	马
乡	乡
丰	丰
王	王
开	开
井	井
天	天
夫	夫
元	元
无	无
云	云
专	专
丐	丐
扎	扎
艺	艺
木	木
五	五
支	支
厅	厅
不	不
犬	犬
太	太
区	区
历	历
歹	歹
友	友
尤	尤
匹	匹
车	车
巨	巨
牙	牙
屯	屯
戈	戈
比	比
互	互
切	切
瓦	瓦
止	止
少	少
曰	曰
日	日
中	中
贝	贝
冈	冈
内	内
水	水
见	见
午	午
牛	牛
手	手
气	气
毛	毛
壬	壬
升	升
夭	夭
长	长
仁	仁
什	什
片	片
仆	仆
化	化
仇	仇
币	币
仍	仍
仅	仅
斤	斤
爪	爪
反	反
介	介
父	父
从	从
仑	仑
今	今
凶	凶
分	分
乏	乏
公	公
仓	仓
月	月
氏	氏
勿	勿
欠	欠
风	风
丹	丹
匀	匀
乌	乌
勾	勾
凤	凤
六	六
文	文
亢	亢
方	方
火	火
为	为
斗	斗
忆	忆
计	计
订	订
户	户
认	认
冗	冗
讥	讥
心	心
尺	尺
引	引
丑	丑
巴	巴
孔	孔
队	队
办	办
以	以
允	允
予	予
邓	邓
劝	劝
双	双
书	书
幻	幻
玉	玉
刊	刊
未	未
末	末
示	示
击	击
打	打
巧	巧
正	正
扑	扑
卉	卉
扒	扒
功	功
扔	扔
去	去
甘	甘
世	世
艾	艾
古	古
节	节
本	本
术	术
可	可
丙	丙
左	左
厉	厉
石	石
右	右
布	布
夯	夯
戊	戊
龙	龙
平	平
灭	灭
轧	轧
东	东
卡	卡
北	北
占	占
凸	凸
卢	卢
业	业
旧	旧
帅	帅
归	归
旦	旦
目	目
且	且
叶	叶
甲	甲
申	申
叮	叮
电	电
号	号
田	田
由	由
只	只
叭	叭
史	史
央	央
兄	兄
叽	叽
叼	叼
叫	叫
叩	叩
叨	叨
另	另
叹	叹
冉	冉
皿	皿
凹	凹
囚	囚
四	四
生	生
矢	矢
失	失
乍	乍
禾	禾
丘	丘
付	付
仗	仗
代	代
仙	仙
们	们
仪	仪
白	白
仔	仔
他	他
斥	斥
瓜	瓜
乎	乎
丛	丛
令	令
用	用
甩	甩
印	印
尔	尔
乐	乐
句	句
匆	匆
册	册
卯	卯
犯	犯
外	外
处	处
冬	冬
鸟	鸟
务	务
包	包
饥	饥
主	主
市	市
立	立
冯	冯
玄	玄
闪	闪
兰	兰
半	半
汁	汁
汇	汇
头	头
汉	汉
宁	宁
穴	穴
它	它
讨	讨
写	写
让	让
礼	礼
训	训
议	议
必	必
讯	讯
记	记
永	永
司	司
尼	尼
民	民
弗	弗
弘	弘
出	出
辽	辽
奶	奶
奴	奴
召	召
加	加
皮	皮
边	边
孕	孕
发	发
圣	圣
对	对
台	台
矛	矛
纠	纠
母	母
幼	幼
丝	丝
邦	邦
式	式
迂	迂
刑	刑
戎	戎
动	动
扛	扛
寺	寺
吉	吉
扣	扣
考	考
托	托
老	老
巩	巩
圾	圾
执	执
扩	扩
扫	扫
地	地
场	场
扬	扬
耳	耳
芋	芋
共	共
芒	芒
亚	亚
芝	芝
朽	朽
朴	朴
机	机
权	权
过	过
臣	臣
吏	吏
再	再
协	协
西	西
压	压
厌	厌
戌	戌
在	在
百	百
有	有
存	存
而	而
页	页
匠	匠
夸	夸
夺	夺
灰	灰
达	达
列	列
死	死
成	成
夹	夹
夷	夷
轨	轨
邪	邪
尧	尧
划	划
迈	迈
毕	毕
至	至
此	此
贞	贞
师	师
尘	尘
尖	尖
劣	劣
光	光
当	当
早	早
吁	吁
吐	吐
吓	吓
虫	虫
曲	曲
团	团
吕	吕
同	同
吊	吊
吃	吃
因	因
吸	吸
吗	吗
吆	吆
屿	屿
屹	屹
岁	岁
帆	帆
回	回
岂	岂
则	则
刚	刚
网	网
肉	肉
年	年
朱	朱
先	先
丢	丢
廷	廷
舌	舌
竹	竹
迁	迁
乔	乔
迄	迄
伟	伟
传	传
乒	乒
乓	乓
休	休
伍	伍
伏	伏
优	优
臼	臼
伐	伐
延	延
仲	仲
件	件
任	任
伤	伤
价	价
伦	伦
份	份
华	华
仰	仰
仿	仿
伙	伙
伪	伪
自	自
伊	伊
血	血
向	向
似	似
后	后
行	行
舟	舟
全	全
会	会
杀	杀
合	合
兆	兆
企	企
众	众
爷	爷
伞	伞
创	创
肌	肌
肋	肋
朵	朵
杂	杂
危	危
旬	旬
旨	旨
旭	旭
负	负
匈	匈
名	名
各	各
多	多
争	争
色	色
壮	壮
冲	冲
妆	妆
冰	冰
庄	庄
庆	庆
亦	亦
刘	刘
齐	齐
交	交
衣	衣
次	次
产	产
决	决
亥	亥
充	充
妄	妄
闭	闭
问	问
闯	闯
羊	羊
并	并
关	关
米	米
灯	灯
州	州
汗	汗
污	污
江	江
汛	汛
池	池
汝	汝
汤	汤
忙	忙
兴	兴
宇	宇
守	守
宅	宅
字	字
安	安
讲	讲
讳	讳
军	军
讶	讶
许	许
讹	讹
论	论
讼	讼
农	农
讽	讽
设	设
访	访
诀	诀
寻	寻
那	那
迅	迅
尽	尽
导	导
异	异
弛	弛
孙	孙
阵	阵
阳	阳
收	收
阶	阶
阴	阴
防	防
奸	奸
如	如
妇	妇
妃	妃
好	好
她	她
妈	妈
戏	戏
羽	羽
观	观
欢	欢
买	买
红	红
驮	驮
纤	纤
驯	驯
约	约
级	级
纪	纪
驰	驰
纫	纫
巡	巡
寿	寿
弄	弄
麦	麦
玖	玖
玛	玛
形	形
进	进
戒	戒
吞	吞
远	远
违	违
韧	韧
运	运
扶	扶
抚	抚
坛	坛
技	技
坏	坏
抠	抠
扰	扰
扼	扼
拒	拒
找	找
批	批
址	址
扯	扯
走	走
抄	抄
贡	贡
汞	汞
坝	坝
攻	攻
赤	赤
折	折
抓	抓
扳	扳
抡	抡
扮	扮
抢	抢
孝	孝
坎	坎
均	均
抑	抑
抛	抛
投	投
坟	坟
坑	坑
抗	抗
坊	坊
抖	抖
护	护
壳	壳
志	志
块	块
扭	扭
声	声
把	把
报	报
拟	拟
却	却
抒	抒
劫	劫
芙	芙
芜	芜
苇	苇
芽	芽
花	花
芹	芹
芥	芥
芬	芬
苍	苍
芳	芳
严	严
芦	芦
芯	芯
劳	劳
克	克
芭	芭
苏	苏
杆	杆
杠	杠
杜	杜
材	材
村	村
杖	杖
杏	杏
杉	杉
巫	巫
极	极
李	李
杨	杨
求	求
甫	甫
匣	匣
更	更
束	束
吾	吾
豆	豆
两	两
酉	酉
丽	丽
医	医
辰	辰
励	励
否	否
还	还
尬	尬
歼	歼
来	来
连	连
轩	轩
步	步
卤	卤
坚	坚
肖	肖
旱	旱
盯	盯
呈	呈
时	时
吴	吴
助	助
县	县
里	里
呆	呆
吱	吱
吠	吠
呕	呕
园	园
旷	旷
围	围
呀	呀
吨	吨
足	足
邮	邮
男	男
困	困
吵	吵
串	串
员	员
呐	呐
听	听
吟	吟
吩	吩
呛	呛
吻	吻
吹	吹
呜	呜
吭	吭
吧	吧
邑	邑
吼	吼
囤	囤
别	别
吮	吮
岖	岖
岗	岗
帐	帐
财	财
针	针
钉	钉
牡	牡
告	告
我	我
乱	乱
利	利
秃	秃
秀	秀
私	私
每	每
兵	兵
估	估
体	体
何	何
佐	佐
佑	佑
但	但
伸	伸
佃	佃
作	作
伯	伯
伶	伶
佣	佣
低	低
你	你
住	住
位	位
伴	伴
身	身
皂	皂
伺	伺
佛	佛
囱	囱
近	近
彻	彻
役	役
返	返
余	余
希	希
坐	坐
谷	谷
妥	妥
含	含
邻	邻
岔	岔
肝	肝
肛	肛
肚	肚
肘	肘
肠	肠
龟	龟
甸	甸
免	免
狂	狂
犹	犹
狈	狈
角	角
删	删
条	条
彤	彤
卵	卵
灸	灸
岛	岛
刨	刨
迎	迎
饭	饭
饮	饮
系	系
言	言
冻	冻
状	状
亩	亩
况	况
床	床
库	库
庇	庇
疗	疗
吝	吝
应	应
这	这
冷	冷
庐	庐
序	序
辛	辛
弃	弃
冶	冶
忘	忘
闰	闰
闲	闲
间	间
闷	闷
判	判
兑	兑
灶	灶
灿	灿
灼	灼
弟	弟
汪	汪
沐	沐
沛	沛
汰	汰
沥	沥
沙	沙
汽	汽
沃	沃
沦	沦
汹	汹
泛	泛
沧	沧
没	没
沟	沟
沪	沪
沈	沈
沉	沉
沁	沁
怀	怀
忧	忧
忱	忱
快	快
完	完
宋	宋
宏	宏
牢	牢
究	究
穷	穷
灾	灾
良	良
证	证
启	启
评	评
补	补
初	初
社	社
祀	祀
识	识
诈	诈
诉	诉
罕	罕
诊	诊
词	词
译	译
君	君
灵	灵
即	即
层	层
屁	屁
尿	尿
尾	尾
迟	迟
局	局
改	改
张	张
忌	忌
际	际
陆	陆
阿	阿
陈	陈
阻	阻
附	附
坠	坠
妓	妓
妙	妙
妖	妖
姊	姊
妨	妨
妒	妒
努	努
忍	忍
劲	劲
矣	矣
鸡	鸡
纬	纬
驱	驱
纯	纯
纱	纱
纲	纲
纳	纳
驳	驳
纵	纵
纷	纷
纸	纸
纹	纹
纺	纺
驴	驴
纽	纽
奉	奉
玩	玩
环	环
武	武
青	青
责	责
现	现
玫	玫
表	表
规	规
抹	抹
卦	卦
坷	坷
坯	坯
拓	拓
拢	拢
拔	拔
坪	坪
拣	拣
坦	坦
担	担
坤	坤
押	押
抽	抽
拐	拐
拖	拖
者	者
拍	拍
顶	顶
拆	拆
拎	拎
拥	拥
抵	抵
拘	拘
势	势
抱	抱
拄	拄
垃	垃
拉	拉
拦	拦
幸	幸
拌	拌
拧	拧
拂	拂
拙	拙
招	招
坡	坡
披	披
拨	拨
择	择
抬	抬
拇	拇
拗	拗
其	其
取	取
茉	茉
苦	苦
昔	昔
苛	苛
若	若
茂	茂
苹	苹
苗	苗
英	英
苟	苟
苑	苑
苞	苞
范	范
直	直
茁	茁
茄	茄
茎	茎
苔	苔
茅	茅
枉	枉
林	林
枝	枝
杯	杯
枢	枢
柜	柜
枚	枚
析	析
板	板
松	松
枪	枪
枫	枫
构	构
杭	杭
杰	杰
述	述
枕	枕
丧	丧
或	或
画	画
卧	卧
事	事
刺	刺
枣	枣
雨	雨
卖	卖
郁	郁
矾	矾
矿	矿
码	码
厕	厕
奈	奈
奔	奔
奇	奇
奋	奋
态	态
欧	欧
殴	殴
垄	垄
妻	妻
轰	轰
顷	顷
转	转
斩	斩
轮	轮
软	软
到	到
非	非
叔	叔
歧	歧
肯	肯
齿	齿
些	些
卓	卓
虎	虎
虏	虏
肾	肾
贤	贤
尚	尚
旺	旺
具	具
味	味
果	果
昆	昆
国	国
哎	哎
咕	咕
昌	昌
呵	呵
畅	畅
明	明
易	易
咙	咙
昂	昂
迪	迪
典	典
固	固
忠	忠
呻	呻
咒	咒
咋	咋
咐	咐
呼	呼
鸣	鸣
咏	咏
呢	呢
咄	咄
咖	咖
岸	岸
岩	岩
帖	帖
罗	罗
帜	帜
帕	帕
岭	岭
凯	凯
败	败
账	账
贩	贩
贬	贬
购	购
贮	贮
图	图
钓	钓
制	制
知	知
迭	迭
氛	氛
垂	垂
牧	牧
物	物
乖	乖
刮	刮
秆	秆
和	和
季	季
委	委
秉	秉
佳	佳
侍	侍
岳	岳
供	供
使	使
例	例
侠	侠
侥	侥
版	版
侄	侄
侦	侦
侣	侣
侧	侧
凭	凭
侨	侨
佩	佩
货	货
侈	侈
依	依
卑	卑
的	的
迫	迫
质	质
欣	欣
征	征
往	往
爬	爬
彼	彼
径	径
所	所
舍	舍
金	金
刹	刹
命	命
肴	肴
斧	斧
爸	爸
采	采
觅	觅
受	受
乳	乳
贪	贪
念	念
贫	贫
忿	忿
肤	肤
肺	肺
肢	肢
肿	肿
胀	胀
朋	朋
股	股
肮	肮
肪	肪
肥	肥
服	服
胁	胁
周	周
昏	昏
鱼	鱼
兔	兔
狐	狐
忽	忽
狗	狗
狞	狞
备	备
饰	饰
饱	饱
饲	饲
变	变
京	京
享	享
庞	庞
店	店
夜	夜
庙	庙
府	府
底	底
疟	疟
疙	疙
疚	疚
剂	剂
卒	卒
郊	郊
庚	庚
废	废
净	净
盲	盲
放	放
刻	刻
育	育
氓	氓
闸	闸
闹	闹
郑	郑
券	券
卷	卷
单	单
炬	炬
炒	炒
炊	炊
炕	炕
炎	炎
炉	炉
沫	沫
浅	浅
法	法
泄	泄
沽	沽
河	河
沾	沾
泪	泪
沮	沮
油	油
泊	泊
沿	沿
泡	泡
注	注
泣	泣
泞	泞
泻	泻
泌	泌
泳	泳
泥	泥
沸	沸
沼	沼
波	波
泼	泼
泽	泽
治	治
怔	怔
怯	怯
怖	怖
性	性
怕	怕
怜	怜
怪	怪
怡	怡
学	学
宝	宝
宗	宗
定	定
宠	宠
宜	宜
审	审
宙	宙
官	官
空	空
帘	帘
宛	宛
实	实
试	试
郎	郎
诗	诗
肩	肩
房	房
诚	诚
衬	衬
衫	衫
视	视
祈	祈
话	话
诞	诞
诡	诡
询	询
该	该
详	详
建	建
肃	肃
录	录
隶	隶
帚	帚
屉	屉
居	居
届	届
刷	刷
屈	屈
弧	弧
弥	弥
弦	弦
承	承
孟	孟
陋	陋
陌	陌
孤	孤
陕	陕
降	降
函	函
限	限
妹	妹
姑	姑
姐	姐
姓	姓
妮	妮
始	始
姆	姆
迢	迢
驾	驾
叁	叁
参	参
艰	艰
线	线
练	练
组	组
绅	绅
细	细
驶	驶
织	织
驹	驹
终	终
驻	驻
绊	绊
驼	驼
绍	绍
绎	绎
经	经
贯	贯
契	契
贰	贰
奏	奏
春	春
帮	帮
玷	玷
珍	珍
玲	玲
珊	珊
玻	玻
毒	毒
型	型
拭	拭
挂	挂
封	封
持	持
拷	拷
拱	拱
项	项
垮	垮
挎	挎
城	城
挟	挟
挠	挠
政	政
赴	赴
赵	赵
挡	挡
拽	拽
哉	哉
挺	挺
括	括
垢	垢
拴	拴
拾	拾
挑	挑
垛	垛
指	指
垫	垫
挣	挣
挤	挤
拼	拼
挖	挖
按	按
挥	挥
挪	挪
拯	拯
某	某
甚	甚
荆	荆
茸	茸
革	革
茬	茬
荐	荐
巷	巷
带	带
草	草
茧	茧
茵	茵
茶	茶
荒	荒
茫	茫
荡	荡
荣	荣
荤	荤
荧	荧
故	故
胡	胡
荫	荫
荔	荔
南	南
药	药
标	标
栈	栈
柑	柑
枯	枯
柄	柄
栋	栋
相	相
查	查
柏	柏
栅	栅
柳	柳
柱	柱
柿	柿
栏	栏
柠	柠
树	树
勃	勃
要	要
柬	柬
咸	咸
威	威
歪	歪
研	研
砖	砖
厘	厘
厚	厚
砌	砌
砂	砂
泵	泵
砚	砚
砍	砍
面	面
耐	耐
耍	耍
牵	牵
鸥	鸥
残	残
殃	殃
轴	轴
轻	轻
鸦	鸦
皆	皆
韭	韭
背	背
战	战
点	点
虐	虐
临	临
览	览
竖	竖
省	省
削	削
尝	尝
昧	昧
盹	盹
是	是
盼	盼
眨	眨
哇	哇
哄	哄
哑	哑
显	显
冒	冒
映	映
星	星
昨	昨
咧	咧
昭	昭
畏	畏
趴	趴
胃	胃
贵	贵
界	界
虹	虹
虾	虾
蚁	蚁
思	思
蚂	蚂
虽	虽
品	品
咽	咽
骂	骂
勋	勋
哗	哗
咱	咱
响	响
哈	哈
哆	哆
咬	咬
咳	咳
咪	咪
哪	哪
哟	哟
炭	炭
峡	峡
罚	罚
贱	贱
贴	贴
贻	贻
骨	骨
幽	幽
钙	钙
钝	钝
钞	钞
钟	钟
钢	钢
钠	钠
钥	钥
钦	钦
钧	钧
钩	钩
钮	钮
卸	卸
缸	缸
拜	拜
看	看
矩	矩
毡	毡
氢	氢
怎	怎
牲	牲
选	选
适	适
秒	秒
香	香
种	种
秋	秋
科	科
重	重
复	复
竿	竿
段	段
便	便
俩	俩
贷	贷
顺	顺
修	修
俏	俏
保	保
促	促
俄	俄
俐	俐
侮	侮
俭	俭
俗	俗
俘	俘
信	信
皇	皇
泉	泉
鬼	鬼
侵	侵
禹	禹
侯	侯
追	追
俊	俊
盾	盾
待	待
徊	徊
衍	衍
律	律
很	很
须	须
叙	叙
剑	剑
逃	逃
食	食
盆	盆
胚	胚
胧	胧
胆	胆
胜	胜
胞	胞
胖	胖
脉	脉
胎	胎
勉	勉
狭	狭
狮	狮
独	独
狰	狰
狡	狡
狱	狱
狠	狠
贸	贸
怨	怨
急	急
饵	饵
饶	饶
蚀	蚀
饺	饺
饼	饼
峦	峦
弯	弯
将	将
奖	奖
哀	哀
亭	亭
亮	亮
度	度
迹	迹
庭	庭
疮	疮
疯	疯
疫	疫
疤	疤
咨	咨
姿	姿
亲	亲
音	音
帝	帝
施	施
闺	闺
闻	闻
闽	闽
阀	阀
阁	阁
差	差
养	养
美	美
姜	姜
叛	叛
送	送
类	类
迷	迷
籽	籽
娄	娄
前	前
首	首
逆	逆
兹	兹
总	总
炼	炼
炸	炸
烁	烁
炮	炮
炫	炫
烂	烂
剃	剃
洼	洼
洁	洁
洪	洪
洒	洒
柒	柒
浇	浇
浊	浊
洞	洞
测	测
洗	洗
活	活
派	派
洽	洽
染	染
洛	洛
浏	浏
济	济
洋	洋
洲	洲
浑	浑
浓	浓
津	津
恃	恃
恒	恒
恢	恢
恍	恍
恬	恬
恤	恤
恰	恰
恼	恼
恨	恨
举	举
觉	觉
宣	宣
宦	宦
室	室
宫	宫
宪	宪
突	突
穿	穿
窃	窃
客	客
诫	诫
冠	冠
诬	诬
语	语
扁	扁
袄	袄
祖	祖
神	神
祝	祝
祠	祠
误	误
诱	诱
诲	诲
说	说
诵	诵
垦	垦
退	退
既	既
屋	屋
昼	昼
屏	屏
屎	屎
费	费
陡	陡
逊	逊
眉	眉
孩	孩
陨	陨
除	除
险	险
院	院
娃	娃
姥	姥
姨	姨
姻	姻
娇	娇
姚	姚
娜	娜
怒	怒
架	架
贺	贺
盈	盈
勇	勇
怠	怠
癸	癸
蚤	蚤
柔	柔
垒	垒
绑	绑
绒	绒
结	结
绕	绕
骄	骄
绘	绘
给	给
绚	绚
骆	骆
络	络
绝	绝
绞	绞
骇	骇
统	统
耕	耕
耘	耘
耗	耗
耙	耙
艳	艳
泰	泰
秦	秦
珠	珠
班	班
素	素
匿	匿
蚕	蚕
顽	顽
盏	盏
匪	匪
捞	捞
栽	栽
捕	捕
埂	埂
捂	捂
振	振
载	载
赶	赶
起	起
盐	盐
捎	捎
捍	捍
捏	捏
埋	埋
捉	捉
捆	捆
捐	捐
损	损
袁	袁
捌	捌
都	都
哲	哲
逝	逝
捡	捡
挫	挫
换	换
挽	挽
挚	挚
热	热
恐	恐
捣	捣
壶	壶
捅	捅
埃	埃
挨	挨
耻	耻
耿	耿
耽	耽
聂	聂
恭	恭
莽	莽
莱	莱
莲	莲
莫	莫
莉	莉
荷	荷
获	获
晋	晋
恶	恶
莹	莹
莺	莺
真	真
框	框
梆	梆
桂	桂
桔	桔
栖	栖
档	档
桐	桐
株	株
桥	桥
桦	桦
栓	栓
桃	桃
格	格
桩	桩
校	校
核	核
样	样
根	根
索	索
哥	哥
速	速
逗	逗
栗	栗
贾	贾
酌	酌
配	配
翅	翅
辱	辱
唇	唇
夏	夏
砸	砸
砰	砰
砾	砾
础	础
破	破
原	原
套	套
逐	逐
烈	烈
殊	殊
殉	殉
顾	顾
轿	轿
较	较
顿	顿
毙	毙
致	致
柴	柴
桌	桌
虑	虑
监	监
紧	紧
党	党
逞	逞
晒	晒
眠	眠
晓	晓
哮	哮
唠	唠
鸭	鸭
晃	晃
哺	哺
晌	晌
剔	剔
晕	晕
蚌	蚌
畔	畔
蚣	蚣
蚊	蚊
蚪	蚪
蚓	蚓
哨	哨
哩	哩
圃	圃
哭	哭
哦	哦
恩	恩
鸯	鸯
唤	唤
唁	唁
哼	哼
唧	唧
啊	啊
唉	唉
唆	唆
罢	罢
峭	峭
峨	峨
峰	峰
圆	圆
峻	峻
贼	贼
贿	贿
赂	赂
赃	赃
钱	钱
钳	钳
钻	钻
钾	钾
铁	铁
铃	铃
铅	铅
缺	缺
氧	氧
氨	氨
特	特
牺	牺
造	造
乘	乘
敌	敌
秤	秤
租	租
积	积
秧	秧
秩	秩
称	称
秘	秘
透	透
笔	笔
笑	笑
笋	笋
债	债
借	借
值	值
倚	倚
俺	俺
倾	倾
倒	倒
倘	倘
俱	俱
倡	倡
候	候
赁	赁
俯	俯
倍	倍
倦	倦
健	健
臭	臭
射	射
躬	躬
息	息
倔	倔
徒	徒
徐	徐
殷	殷
舰	舰
舱	舱
般	般
航	航
途	途
拿	拿
耸	耸
爹	爹
舀	舀
爱	爱
豺	豺
豹	豹
颁	颁
颂	颂
翁	翁
胰	胰
脆	脆
脂	脂
胸	胸
胳	胳
脏	脏
脐	脐
胶	胶
脑	脑
脓	脓
逛	逛
狸	狸
狼	狼
卿	卿
逢	逢
鸵	鸵
留	留
鸳	鸳
皱	皱
饿	饿
馁	馁
凌	凌
凄	凄
恋	恋
桨	桨
浆	浆
衰	衰
衷	衷
高	高
郭	郭
席	席
准	准
座	座
症	症
病	病
疾	疾
斋	斋
疹	疹
疼	疼
疲	疲
脊	脊
效	效
离	离
紊	紊
唐	唐
瓷	瓷
资	资
凉	凉
站	站
剖	剖
竞	竞
部	部
旁	旁
旅	旅
畜	畜
阅	阅
羞	羞
羔	羔
瓶	瓶
拳	拳
粉	粉
料	料
益	益
兼	兼
烤	烤
烘	烘
烦	烦
烧	烧
烛	烛
烟	烟
烙	烙
递	递
涛	涛
浙	浙
涝	涝
浦	浦
酒	酒
涉	涉
消	消
涡	涡
浩	浩
海	海
涂	涂
浴	浴
浮	浮
涣	涣
涤	涤
流	流
润	润
涧	涧
涕	涕
浪	浪
浸	浸
涨	涨
烫	烫
涩	涩
涌	涌
悖	悖
悟	悟
悄	悄
悍	悍
悔	悔
悯	悯
悦	悦
害	害
宽	宽
家	家
宵	宵
宴	宴
宾	宾
窍	窍
窄	窄
容	容
宰	宰
案	案
请	请
朗	朗
诸	诸
诺	诺
读	读
扇	扇
诽	诽
袜	袜
袖	袖
袍	袍
被	被
祥	祥
课	课
冥	冥
谁	谁
调	调
冤	冤
谅	谅
谆	谆
谈	谈
谊	谊
剥	剥
恳	恳
展	展
剧	剧
屑	屑
弱	弱
陵	陵
祟	祟
陶	陶
陷	陷
陪	陪
娱	娱
娟	娟
恕	恕
娥	娥
娘	娘
通	通
能	能
难	难
预	预
桑	桑
绢	绢
绣	绣
验	验
继	继
骏	骏
球	球
琐	琐
理	理
琉	琉
琅	琅
捧	捧
堵	堵
措	措
描	描
域	域
捺	捺
掩	掩
捷	捷
排	排
焉	焉
掉	掉
捶	捶
赦	赦
堆	堆
推	推
埠	埠
掀	掀
授	授
捻	捻
教	教
掏	掏
掐	掐
掠	掠
掂	掂
培	培
接	接
掷	掷
控	控
探	探
据	据
掘	掘
掺	掺
职	职
基	基
聆	聆
勘	勘
聊	聊
娶	娶
著	著
菱	菱
勒	勒
黄	黄
菲	菲
萌	萌
萝	萝
菌	菌
萎	萎
菜	菜
萄	萄
菊	菊
菩	菩
萍	萍
菠	菠
萤	萤
营	营
萧	萧
萨	萨
菇	菇
械	械
彬	彬
梦	梦
婪	婪
梗	梗
梧	梧
梢	梢
梅	梅
检	检
梳	梳
梯	梯
桶	桶
梭	梭
救	救
曹	曹
副	副
票	票
酝	酝
酗	酗
厢	厢
戚	戚
硅	硅
硕	硕
奢	奢
盔	盔
爽	爽
聋	聋
袭	袭
盛	盛
匾	匾
雪	雪
辅	辅
辆	辆
颅	颅
虚	虚
彪	彪
雀	雀
堂	堂
常	常
眶	眶
匙	匙
晨	晨
睁	睁
眯	眯
眼	眼
悬	悬
野	野
啪	啪
啦	啦
曼	曼
晦	晦
晚	晚
啄	啄
啡	啡
距	距
趾	趾
啃	啃
跃	跃
略	略
蚯	蚯
蛀	蛀
蛇	蛇
唬	唬
累	累
鄂	鄂
唱	唱
患	患
啰	啰
唾	唾
唯	唯
啤	啤
啥	啥
啸	啸
崖	崖
崎	崎
崭	崭
逻	逻
崔	崔
帷	帷
崩	崩
崇	崇
崛	崛
婴	婴
圈	圈
铐	铐
铛	铛
铝	铝
铜	铜
铭	铭
铲	铲
银	银
矫	矫
甜	甜
秸	秸
梨	梨
犁	犁
秽	秽
移	移
笨	笨
笼	笼
笛	笛
笙	笙
符	符
第	第
敏	敏
做	做
袋	袋
悠	悠
偿	偿
偶	偶
偎	偎
偷	偷
您	您
售	售
停	停
偏	偏
躯	躯
兜	兜
假	假
衅	衅
徘	徘
徙	徙
得	得
衔	衔
盘	盘
舶	舶
船	船
舵	舵
斜	斜
盒	盒
鸽	鸽
敛	敛
悉	悉
欲	欲
彩	彩
领	领
脚	脚
脖	脖
脯	脯
豚	豚
脸	脸
脱	脱
象	象
够	够
逸	逸
猜	猜
猪	猪
猎	猎
猫	猫
凰	凰
猖	猖
猛	猛
祭	祭
馅	馅
馆	馆
凑	凑
减	减
毫	毫
烹	烹
庶	庶
麻	麻
庵	庵
痊	痊
痒	痒
痕	痕
廊	廊
康	康
庸	庸
鹿	鹿
盗	盗
章	章
竟	竟
商	商
族	族
旋	旋
望	望
率	率
阎	阎
阐	阐
着	着
羚	羚
盖	盖
眷	眷
粘	粘
粗	粗
粒	粒
断	断
剪	剪
兽	兽
焊	焊
焕	焕
清	清
添	添
鸿	鸿
淋	淋
涯	涯
淹	淹
渠	渠
渐	渐
淑	淑
淌	淌
混	混
淮	淮
淆	淆
渊	渊
淫	淫
渔	渔
淘	淘
淳	淳
液	液
淤	淤
淡	淡
淀	淀
深	深
涮	涮
涵	涵
婆	婆
梁	梁
渗	渗
情	情
惜	惜
惭	惭
悼	悼
惧	惧
惕	惕
惟	惟
惊	惊
惦	惦
悴	悴
惋	惋
惨	惨
惯	惯
寇	寇
寅	寅
寄	寄
寂	寂
宿	宿
窒	窒
窑	窑
密	密
谋	谋
谍	谍
谎	谎
谐	谐
袱	袱
祷	祷
祸	祸
谓	谓
谚	谚
谜	谜
逮	逮
敢	敢
尉	尉
屠	屠
弹	弹
隋	隋
堕	堕
随	随
蛋	蛋
隅	隅
隆	隆
隐	隐
婚	婚
婶	婶
婉	婉
颇	颇
颈	颈
绩	绩
绪	绪
续	续
骑	骑
绰	绰
绳	绳
维	维
绵	绵
绷	绷
绸	绸
综	综
绽	绽
绿	绿
缀	缀
巢	巢
琴	琴
琳	琳
琢	琢
琼	琼
斑	斑
替	替
揍	揍
款	款
堪	堪
塔	塔
搭	搭
堰	堰
揩	揩
越	越
趁	趁
趋	趋
超	超
揽	揽
堤	堤
提	提
博	博
揭	揭
喜	喜
彭	彭
揣	揣
插	插
揪	揪
搜	搜
煮	煮
援	援
搀	搀
裁	裁
搁	搁
搓	搓
搂	搂
搅	搅
壹	壹
握	握
搔	搔
揉	揉
斯	斯
期	期
欺	欺
联	联
葫	葫
散	散
惹	惹
葬	葬
募	募
葛	葛
董	董
葡	葡
敬	敬
葱	葱
蒋	蒋
蒂	蒂
落	落
韩	韩
朝	朝
辜	辜
葵	葵
棒	棒
棱	棱
棋	棋
椰	椰
植	植
森	森
焚	焚
椅	椅
椒	椒
棵	棵
棍	棍
椎	椎
棉	棉
棚	棚
棕	棕
棺	棺
榔	榔
椭	椭
惠	惠
惑	惑
逼	逼
粟	粟
棘	棘
酣	酣
酥	酥
厨	厨
厦	厦
硬	硬
硝	硝
确	确
硫	硫
雁	雁
殖	殖
裂	裂
雄	雄
颊	颊
雳	雳
暂	暂
雅	雅
翘	翘
辈	辈
悲	悲
紫	紫
凿	凿
辉	辉
敞	敞
棠	棠
赏	赏
掌	掌
晴	晴
睐	睐
暑	暑
最	最
晰	晰
量	量
鼎	鼎
喷	喷
喳	喳
晶	晶
喇	喇
遇	遇
喊	喊
遏	遏
晾	晾
景	景
畴	畴
践	践
跋	跋
跌	跌
跑	跑
跛	跛
遗	遗
蛙	蛙
蛛	蛛
蜓	蜓
蜒	蜒
蛤	蛤
喝	喝
鹃	鹃
喂	喂
喘	喘
喉	喉
喻	喻
啼	啼
喧	喧
嵌	嵌
幅	幅
帽	帽
赋	赋
赌	赌
赎	赎
赐	赐
赔	赔
黑	黑
铸	铸
铺	铺
链	链
销	销
锁	锁
锄	锄
锅	锅
锈	锈
锋	锋
锌	锌
锐	锐
甥	甥
掰	掰
短	短
智	智
氮	氮
毯	毯
氯	氯
鹅	鹅
剩	剩
稍	稍
程	程
稀	稀
税	税
筐	筐
等	等
筑	筑
策	策
筛	筛
筒	筒
筏	筏
答	答
筋	筋
筝	筝
傲	傲
傅	傅
牌	牌
堡	堡
集	集
焦	焦
傍	傍
储	储
皓	皓
皖	皖
粤	粤
奥	奥
街	街
惩	惩
御	御
循	循
艇	艇
舒	舒
逾	逾
番	番
释	释
禽	禽
腊	腊
脾	脾
腋	腋
腔	腔
腕	腕
鲁	鲁
猩	猩
猬	猬
猾	猾
猴	猴
惫	惫
然	然
馈	馈
馋	馋
装	装
蛮	蛮
就	就
敦	敦
斌	斌
痘	痘
痢	痢
痪	痪
痛	痛
童	童
竣	竣
阔	阔
善	善
翔	翔
羡	羡
普	普
粪	粪
尊	尊
奠	奠
道	道
遂	遂
曾	曾
焰	焰
港	港
滞	滞
湖	湖
湘	湘
渣	渣
渤	渤
渺	渺
湿	湿
温	温
渴	渴
溃	溃
溅	溅
滑	滑
湃	湃
渝	渝
湾	湾
渡	渡
游	游
滋	滋
渲	渲
溉	溉
愤	愤
慌	慌
惰	惰
愕	愕
愣	愣
惶	惶
愧	愧
愉	愉
慨	慨
割	割
寒	寒
富	富
寓	寓
窜	窜
窝	窝
窖	窖
窗	窗
窘	窘
遍	遍
雇	雇
裕	裕
裤	裤
裙	裙
禅	禅
禄	禄
谢	谢
谣	谣
谤	谤
谦	谦
犀	犀
属	属
屡	屡
强	强
粥	粥
疏	疏
隔	隔
隙	隙
隘	隘
媒	媒
絮	絮
嫂	嫂
媚	媚
婿	婿
登	登
缅	缅
缆	缆
缉	缉
缎	缎
缓	缓
缔	缔
缕	缕
骗	骗
编	编
骚	骚
缘	缘
瑟	瑟
鹉	鹉
瑞	瑞
瑰	瑰
瑙	瑙
魂	魂
肆	肆
摄	摄
摸	摸
填	填
搏	搏
塌	塌
鼓	鼓
摆	摆
携	携
搬	搬
摇	摇
搞	搞
塘	塘
摊	摊
聘	聘
斟	斟
蒜	蒜
勤	勤
靴	靴
靶	靶
鹊	鹊
蓝	蓝
墓	墓
幕	幕
蓬	蓬
蓄	蓄
蒲	蒲
蓉	蓉
蒙	蒙
蒸	蒸
献	献
椿	椿
禁	禁
楚	楚
楷	楷
榄	榄
想	想
槐	槐
榆	榆
楼	楼
概	概
赖	赖
酪	酪
酬	酬
感	感
碍	碍
碘	碘
碑	碑
碎	碎
碰	碰
碗	碗
碌	碌
尴	尴
雷	雷
零	零
雾	雾
雹	雹
辐	辐
辑	辑
输	输
督	督
频	频
龄	龄
鉴	鉴
睛	睛
睹	睹
睦	睦
瞄	瞄
睫	睫
睡	睡
睬	睬
嗜	嗜
鄙	鄙
嗦	嗦
愚	愚
暖	暖
盟	盟
歇	歇
暗	暗
暇	暇
照	照
畸	畸
跨	跨
跷	跷
跳	跳
跺	跺
跪	跪
路	路
跤	跤
跟	跟
遣	遣
蜈	蜈
蜗	蜗
蛾	蛾
蜂	蜂
蜕	蜕
嗅	嗅
嗡	嗡
嗓	嗓
署	署
置	置
罪	罪
罩	罩
蜀	蜀
幌	幌
错	错
锚	锚
锡	锡
锣	锣
锤	锤
锥	锥
锦	锦
键	键
锯	锯
锰	锰
矮	矮
辞	辞
稚	稚
稠	稠
颓	颓
愁	愁
筹	筹
签	签
简	简
筷	筷
毁	毁
舅	舅
鼠	鼠
催	催
傻	傻
像	像
躲	躲
魁	魁
衙	衙
微	微
愈	愈
遥	遥
腻	腻
腰	腰
腥	腥
腮	腮
腹	腹
腺	腺
鹏	鹏
腾	腾
腿	腿
鲍	鲍
猿	猿
颖	颖
触	触
解	解
煞	煞
雏	雏
馍	馍
馏	馏
酱	酱
禀	禀
痹	痹
廓	廓
痴	痴
痰	痰
廉	廉
靖	靖
新	新
韵	韵
意	意
誊	誊
粮	粮
数	数
煎	煎
塑	塑
慈	慈
煤	煤
煌	煌
满	满
漠	漠
滇	滇
源	源
滤	滤
滥	滥
滔	滔
溪	溪
溜	溜
漓	漓
滚	滚
溢	溢
溯	溯
滨	滨
溶	溶
溺	溺
粱	粱
滩	滩
慎	慎
誉	誉
塞	塞
寞	寞
窥	窥
窟	窟
寝	寝
谨	谨
褂	褂
裸	裸
福	福
谬	谬
群	群
殿	殿
辟	辟
障	障
媳	媳
嫉	嫉
嫌	嫌
嫁	嫁
叠	叠
缚	缚
缝	缝
缠	缠
缤	缤
剿	剿
静	静
碧	碧
璃	璃
赘	赘
熬	熬
墙	墙
墟	墟
嘉	嘉
摧	摧
赫	赫
截	截
誓	誓
境	境
摘	摘
摔	摔
撇	撇
聚	聚
慕	慕
暮	暮
摹	摹
蔓	蔓
蔑	蔑
蔡	蔡
蔗	蔗
蔽	蔽
蔼	蔼
熙	熙
蔚	蔚
兢	兢
模	模
槛	槛
榴	榴
榜	榜
榨	榨
榕	榕
歌	歌
遭	遭
酵	酵
酷	酷
酿	酿
酸	酸
碟	碟
碱	碱
碳	碳
磁	磁
愿	愿
需	需
辖	辖
辗	辗
雌	雌
裳	裳
颗	颗
瞅	瞅
墅	墅
嗽	嗽
踊	踊
蜻	蜻
蜡	蜡
蝇	蝇
蜘	蜘
蝉	蝉
嘛	嘛
嘀	嘀
赚	赚
锹	锹
锻	锻
镀	镀
舞	舞
舔	舔
稳	稳
熏	熏
箕	箕
算	算
箩	箩
管	管
箫	箫
舆	舆
僚	僚
僧	僧
鼻	鼻
魄	魄
魅	魅
貌	貌
膜	膜
膊	膊
膀	膀
鲜	鲜
疑	疑
孵	孵
馒	馒
裹	裹
敲	敲
豪	豪
膏	膏
遮	遮
腐	腐
瘩	瘩
瘟	瘟
瘦	瘦
辣	辣
彰	彰
竭	竭
端	端
旗	旗
精	精
粹	粹
歉	歉
弊	弊
熄	熄
熔	熔
煽	煽
潇	潇
漆	漆
漱	漱
漂	漂
漫	漫
滴	滴
漾	漾
演	演
漏	漏
慢	慢
慷	慷
寨	寨
赛	赛
寡	寡
察	察
蜜	蜜
寥	寥
谭	谭
肇	肇
褐	褐
褪	褪
谱	谱
隧	隧
嫩	嫩
翠	翠
熊	熊
凳	凳
骡	骡
缩	缩
慧	慧
撵	撵
撕	撕
撒	撒
撩	撩
趣	趣
趟	趟
撑	撑
撮	撮
撬	撬
播	播
擒	擒
墩	墩
撞	撞
撤	撤
增	增
撰	撰
聪	聪
鞋	鞋
鞍	鞍
蕉	蕉
蕊	蕊
蔬	蔬
蕴	蕴
横	横
槽	槽
樱	樱
橡	橡
樟	樟
橄	橄
敷	敷
豌	豌
飘	飘
醋	醋
醇	醇
醉	醉
磕	磕
磊	磊
磅	磅
碾	碾
震	震
霄	霄
霉	霉
瞒	瞒
题	题
暴	暴
瞎	瞎
嘻	嘻
嘶	嘶
嘲	嘲
嘹	嘹
影	影
踢	踢
踏	踏
踩	踩
踪	踪
蝶	蝶
蝴	蝴
蝠	蝠
蝎	蝎
蝌	蝌
蝗	蝗
蝙	蝙
嘿	嘿
嘱	嘱
幢	幢
墨	墨
镇	镇
镐	镐
镑	镑
靠	靠
稽	稽
稻	稻
黎	黎
稿	稿
稼	稼
箱	箱
篓	篓
箭	箭
篇	篇
僵	僵
躺	躺
僻	僻
德	德
艘	艘
膝	膝
膛	膛
鲤	鲤
鲫	鲫
熟	熟
摩	摩
褒	褒
瘪	瘪
瘤	瘤
瘫	瘫
凛	凛
颜	颜
毅	毅
糊	糊
遵	遵
憋	憋
潜	潜
澎	澎
潮	潮
潭	潭
鲨	鲨
澳	澳
潘	潘
澈	澈
澜	澜
澄	澄
懂	懂
憔	憔
懊	懊
憎	憎
额	额
翩	翩
褥	褥
谴	谴
鹤	鹤
憨	憨
慰	慰
劈	劈
履	履
豫	豫
缭	缭
撼	撼
擂	擂
操	操
擅	擅
燕	燕
蕾	蕾
薯	薯
薛	薛
薇	薇
擎	擎
薪	薪
薄	薄
颠	颠
翰	翰
噩	噩
橱	橱
橙	橙
橘	橘
整	整
融	融
瓢	瓢
醒	醒
霍	霍
霎	霎
辙	辙
冀	冀
餐	餐
嘴	嘴
踱	踱
蹄	蹄
蹂	蹂
蟆	蟆
螃	螃
器	器
噪	噪
鹦	鹦
赠	赠
默	默
黔	黔
镜	镜
赞	赞
穆	穆
篮	篮
篡	篡
篷	篷
篱	篱
儒	儒
邀	邀
衡	衡
膨	膨
雕	雕
鲸	鲸
磨	磨
瘾	瘾
瘸	瘸
凝	凝
辨	辨
辩	辩
糙	糙
糖	糖
糕	糕
燃	燃
濒	濒
澡	澡
激	激
懒	懒
憾	憾
懈	懈
窿	窿
壁	壁
避	避
缰	缰
缴	缴
戴	戴
擦	擦
鞠	鞠
藏	藏
藐	藐
檬	檬
檐	檐
檀	檀
礁	礁
磷	磷
霜	霜
霞	霞
瞧	瞧
瞬	瞬
瞳	瞳
瞩	瞩
瞪	瞪
曙	曙
蹋	蹋
蹈	蹈
螺	螺
蟋	蟋
蟀	蟀
嚎	嚎
赡	赡
穗	穗
魏	魏
簧	簧
簇	簇
繁	繁
徽	徽
爵	爵
朦	朦
臊	臊
鳄	鳄
癌	癌
辫	辫
赢	赢
糟	糟
糠	糠
燥	燥
懦	懦
豁	豁
臀	臀
臂	臂
翼	翼
骤	骤
藕	藕
鞭	鞭
藤	藤
覆	覆
瞻	瞻
蹦	蹦
嚣	嚣
镰	镰
翻	翻
鳍	鳍
鹰	鹰
瀑	瀑
襟	襟
璧	璧
戳	戳
孽	孽
警	警
蘑	蘑
藻	藻
攀	攀
曝	曝
蹲	蹲
蹭	蹭
蹬	蹬
巅	巅
簸	簸
簿	簿
蟹	蟹
颤	颤
靡	靡
癣	癣
瓣	瓣
羹	羹
鳖	鳖
爆	爆
疆	疆
鬓	鬓
壤	壤
馨	馨
耀	耀
躁	躁
蠕	蠕
嚼	嚼
嚷	嚷
巍	巍
籍	籍
鳞	鳞
魔	魔
糯	糯
灌	灌
譬	譬
蠢	蠢
霸	霸
露	露
霹	霹
躏	躏
黯	黯
髓	髓
赣	赣
囊	囊
镶	镶
瓤	瓤
罐	罐
矗	矗
乂	乂
乜	乜
兀	兀
弋	弋
孑	孑
孓	孓
幺	幺
亓	亓
韦	韦
廿	廿
丏	丏
卅	卅
仄	仄
厄	厄
仃	仃
仉	仉
仂	仂
兮	兮
刈	刈
爻	爻
卞	卞
闩	闩
讣	讣
尹	尹
夬	夬
爿	爿
毋	毋
邗	邗
邛	邛
艽	艽
艿	艿
札	札
叵	叵
匝	匝
丕	丕
匜	匜
劢	劢
卟	卟
叱	叱
叻	叻
仨	仨
仕	仕
仟	仟
仡	仡
仫	仫
仞	仞
卮	卮
氐	氐
犰	犰
刍	刍
邝	邝
邙	邙
汀	汀
讦	讦
讧	讧
讪	讪
讫	讫
尻	尻
阡	阡
尕	尕
弁	弁
驭	驭
匡	匡
耒	耒
玎	玎
玑	玑
邢	邢
圩	圩
圬	圬
圭	圭
扦	扦
圪	圪
圳	圳
圹	圹
扪	扪
圮	圮
圯	圯
芊	芊
芍	芍
芄	芄
芨	芨
芑	芑
芎	芎
芗	芗
亘	亘
厍	厍
夼	夼
戍	戍
尥	尥
乩	乩
旯	旯
曳	曳
岌	岌
屺	屺
凼	凼
囡	囡
钇	钇
缶	缶
氘	氘
氖	氖
牝	牝
伎	伎
伛	伛
伢	伢
佤	佤
仵	仵
伥	伥
伧	伧
伉	伉
伫	伫
囟	囟
汆	汆
刖	刖
夙	夙
旮	旮
刎	刎
犷	犷
犸	犸
舛	舛
凫	凫
邬	邬
饧	饧
汕	汕
汔	汔
汐	汐
汲	汲
汜	汜
汊	汊
忖	忖
忏	忏
讴	讴
讵	讵
祁	祁
讷	讷
聿	聿
艮	艮
厾	厾
阱	阱
阮	阮
丞	丞
妁	妁
牟	牟
纡	纡
纣	纣
纥	纥
纨	纨
玕	玕
玙	玙
抟	抟
抔	抔
圻	圻
坂	坂
坍	坍
坞	坞
抃	抃
抉	抉
㧐	㧐
芫	芫
邯	邯
芸	芸
芾	芾
苈	苈
苣	苣
芷	芷
芮	芮
苋	苋
芼	芼
苌	苌
苁	苁
芩	芩
芪	芪
芡	芡
芟	芟
苄	苄
苎	苎
苡	苡
杌	杌
杓	杓
杞	杞
杈	杈
忑	忑
孛	孛
邴	邴
邳	邳
矶	矶
奁	奁
豕	豕
忒	忒
欤	欤
轫	轫
迓	迓
邶	邶
忐	忐
卣	卣
邺	邺
旰	旰
呋	呋
呒	呒
呓	呓
呔	呔
呖	呖
呃	呃
旸	旸
吡	吡
町	町
虬	虬
呗	呗
吽	吽
吣	吣
吲	吲
帏	帏
岐	岐
岈	岈
岘	岘
岑	岑
岚	岚
兕	兕
囵	囵
囫	囫
钊	钊
钋	钋
钌	钌
迕	迕
氙	氙
氚	氚
牤	牤
佞	佞
邱	邱
攸	攸
佚	佚
佝	佝
佟	佟
佗	佗
伽	伽
彷	彷
佘	佘
佥	佥
孚	孚
豸	豸
坌	坌
肟	肟
邸	邸
奂	奂
劬	劬
狄	狄
狁	狁
鸠	鸠
邹	邹
饨	饨
饩	饩
饪	饪
饫	饫
饬	饬
亨	亨
庑	庑
庋	庋
疔	疔
疖	疖
肓	肓
闱	闱
闳	闳
闵	闵
羌	羌
炀	炀
沣	沣
沅	沅
沔	沔
沤	沤
沌	沌
沏	沏
沚	沚
汩	汩
汨	汨
沂	沂
汾	汾
沨	沨
汴	汴
汶	汶
沆	沆
沩	沩
泐	泐
怃	怃
怄	怄
忡	忡
忤	忤
忾	忾
怅	怅
忻	忻
忪	忪
怆	怆
忭	忭
忸	忸
诂	诂
诃	诃
诅	诅
诋	诋
诌	诌
诏	诏
诒	诒
孜	孜
陇	陇
陀	陀
陂	陂
陉	陉
妍	妍
妩	妩
妪	妪
妣	妣
妊	妊
妗	妗
妫	妫
妞	妞
姒	姒
妤	妤
邵	邵
劭	劭
刭	刭
甬	甬
邰	邰
纭	纭
纰	纰
纴	纴
纶	纶
纾	纾
玮	玮
玡	玡
玭	玭
玠	玠
玢	玢
玥	玥
玦	玦
盂	盂
忝	忝
匦	匦
坩	坩
抨	抨
拤	拤
坫	坫
拈	拈
垆	垆
抻	抻
劼	劼
拃	拃
拊	拊
坼	坼
坻	坻
㧟	㧟
坨	坨
坭	坭
抿	抿
坳	坳
耶	耶
苷	苷
苯	苯
苤	苤
茏	茏
苫	苫
苜	苜
苴	苴
苒	苒
苘	苘
茌	茌
苻	苻
苓	苓
茚	茚
茆	茆
茑	茑
茓	茓
茔	茔
茕	茕
茀	茀
苕	苕
枥	枥
枇	枇
杪	杪
杳	杳
枧	枧
杵	杵
枨	枨
枞	枞
枋	枋
杻	杻
杷	杷
杼	杼
矸	矸
砀	砀
刳	刳
奄	奄
瓯	瓯
殁	殁
郏	郏
轭	轭
郅	郅
鸢	鸢
盱	盱
昊	昊
昙	昙
杲	杲
昃	昃
咂	咂
呸	呸
昕	昕
昀	昀
旻	旻
昉	昉
炅	炅
咔	咔
畀	畀
虮	虮
咀	咀
呷	呷
黾	黾
呱	呱
呤	呤
咚	咚
咆	咆
咛	咛
呶	呶
呣	呣
呦	呦
咝	咝
岢	岢
岿	岿
岬	岬
岫	岫
帙	帙
岣	岣
峁	峁
刿	刿
迥	迥
岷	岷
剀	剀
帔	帔
峄	峄
沓	沓
囹	囹
罔	罔
钍	钍
钎	钎
钏	钏
钒	钒
钕	钕
钗	钗
邾	邾
迮	迮
牦	牦
竺	竺
迤	迤
佶	佶
佬	佬
佰	佰
侑	侑
侉	侉
臾	臾
岱	岱
侗	侗
侃	侃
侏	侏
侩	侩
佻	佻
佾	佾
侪	侪
佼	佼
佯	佯
侬	侬
帛	帛
阜	阜
侔	侔
徂	徂
刽	刽
郄	郄
怂	怂
籴	籴
瓮	瓮
戗	戗
肼	肼
䏝	䏝
肽	肽
肱	肱
肫	肫
剁	剁
迩	迩
郇	郇
狙	狙
狎	狎
狍	狍
狒	狒
咎	咎
炙	炙
枭	枭
饯	饯
饴	饴
冽	冽
冼	冼
庖	庖
疠	疠
疝	疝
疡	疡
兖	兖
妾	妾
劾	劾
炜	炜
𬉼	𬉼
炖	炖
炘	炘
炝	炝
炔	炔
泔	泔
沭	沭
泷	泷
泸	泸
泱	泱
泅	泅
泗	泗
泠	泠
泺	泺
泖	泖
泫	泫
泮	泮
沱	沱
泯	泯
泓	泓
泾	泾
怙	怙
怵	怵
怦	怦
怛	怛
怏	怏
怍	怍
㤘	㤘
怩	怩
怫	怫
怿	怿
宕	宕
穹	穹
宓	宓
诓	诓
诔	诔
诖	诖
诘	诘
戾	戾
诙	诙
戽	戽
郓	郓
衩	衩
祆	祆
祎	祎
祉	祉
诛	诛
诜	诜
诟	诟
诠	诠
诣	诣
诤	诤
诧	诧
诨	诨
诩	诩
戕	戕
孢	孢
亟	亟
陔	陔
妲	妲
妯	妯
姗	姗
帑	帑
弩	弩
孥	孥
驽	驽
虱	虱
迦	迦
迨	迨
绀	绀
绁	绁
绂	绂
驷	驷
驸	驸
绉	绉
绌	绌
驿	驿
骀	骀
甾	甾
珏	珏
珐	珐
珂	珂
珑	珑
玳	玳
珀	珀
顸	顸
珉	珉
珈	珈
拮	拮
垭	垭
挝	挝
垣	垣
挞	挞
垤	垤
赳	赳
贲	贲
垱	垱
垌	垌
郝	郝
垧	垧
垓	垓
挦	挦
垠	垠
茜	茜
荚	荚
荑	荑
贳	贳
荜	荜
莒	莒
茼	茼
茴	茴
茱	茱
莛	莛
荞	荞
茯	茯
荏	荏
荇	荇
荃	荃
荟	荟
荀	荀
茗	茗
荠	荠
茭	茭
茨	茨
垩	垩
荥	荥
荦	荦
荨	荨
荩	荩
荪	荪
茹	茹
荬	荬
荮	荮
柰	柰
栉	栉
柯	柯
柘	柘
栊	栊
柩	柩
枰	枰
栌	栌
柙	柙
枵	枵
柚	柚
枳	枳
柞	柞
柝	柝
栀	栀
柢	柢
栎	栎
枸	枸
柈	柈
柁	柁
枷	枷
柽	柽
剌	剌
酊	酊
郦	郦
甭	甭
砗	砗
砘	砘
砒	砒
斫	斫
砭	砭
砜	砜
奎	奎
耷	耷
虺	虺
殂	殂
殇	殇
殄	殄
殆	殆
轱	轱
轲	轲
轳	轳
轶	轶
轸	轸
虿	虿
毖	毖
觇	觇
尜	尜
哐	哐
眄	眄
眍	眍
𠳐	𠳐
郢	郢
眇	眇
眊	眊
眈	眈
禺	禺
哂	哂
咴	咴
曷	曷
昴	昴
昱	昱
昵	昵
咦	咦
哓	哓
哔	哔
畎	畎
毗	毗
呲	呲
胄	胄
畋	畋
畈	畈
虼	虼
虻	虻
盅	盅
咣	咣
哕	哕
剐	剐
郧	郧
咻	咻
囿	囿
咿	咿
哌	哌
哙	哙
哚	哚
咯	咯
咩	咩
咤	咤
哝	哝
哏	哏
哞	哞
峙	峙
峣	峣
罘	罘
帧	帧
峒	峒
峤	峤
峋	峋
峥	峥
贶	贶
钚	钚
钛	钛
钡	钡
钣	钣
钤	钤
钨	钨
钫	钫
钯	钯
氡	氡
氟	氟
牯	牯
郜	郜
秕	秕
秭	秭
竽	竽
笈	笈
笃	笃
俦	俦
俨	俨
俅	俅
俪	俪
叟	叟
垡	垡
牮	牮
俣	俣
俚	俚
皈	皈
俑	俑
俟	俟
逅	逅
徇	徇
徉	徉
舢	舢
俞	俞
郗	郗
俎	俎
郤	郤
爰	爰
郛	郛
瓴	瓴
胨	胨
胪	胪
胛	胛
胂	胂
胙	胙
胍	胍
胗	胗
胝	胝
朐	朐
胫	胫
鸨	鸨
匍	匍
狨	狨
狯	狯
飑	飑
狩	狩
狲	狲
訇	訇
逄	逄
昝	昝
饷	饷
饸	饸
饹	饹
胤	胤
孪	孪
娈	娈
弈	弈
奕	奕
庥	庥
疬	疬
疣	疣
疥	疥
疭	疭
庠	庠
竑	竑
彦	彦
飒	飒
闼	闼
闾	闾
闿	闿
阂	阂
羑	羑
迸	迸
籼	籼
酋	酋
炳	炳
炻	炻
炽	炽
炯	炯
烀	烀
炷	炷
烃	烃
洱	洱
洹	洹
洧	洧
洌	洌
浃	浃
洇	洇
洄	洄
洙	洙
涎	涎
洎	洎
洫	洫
浍	浍
洮	洮
洵	洵
浒	浒
浔	浔
浕	浕
洳	洳
恸	恸
恓	恓
恹	恹
恫	恫
恺	恺
恻	恻
恂	恂
恪	恪
恽	恽
宥	宥
扃	扃
衲	衲
衽	衽
衿	衿
袂	袂
祛	祛
祜	祜
祓	祓
祚	祚
诮	诮
祗	祗
祢	祢
诰	诰
诳	诳
鸩	鸩
昶	昶
郡	郡
咫	咫
弭	弭
牁	牁
胥	胥
陛	陛
陟	陟
娅	娅
姮	姮
娆	娆
姝	姝
姣	姣
姘	姘
姹	姹
怼	怼
羿	羿
炱	炱
矜	矜
绔	绔
骁	骁
骅	骅
绗	绗
绛	绛
骈	骈
耖	耖
挈	挈
珥	珥
珙	珙
顼	顼
珰	珰
珩	珩
珧	珧
珣	珣
珞	珞
琤	琤
珲	珲
敖	敖
恚	恚
埔	埔
埕	埕
埘	埘
埙	埙
埚	埚
挹	挹
耆	耆
耄	耄
埒	埒
捋	捋
贽	贽
垸	垸
捃	捃
盍	盍
荸	荸
莆	莆
莳	莳
莴	莴
莪	莪
莠	莠
莓	莓
莜	莜
莅	莅
荼	荼
莩	莩
荽	荽
莸	莸
荻	荻
莘	莘
莎	莎
莞	莞
莨	莨
鸪	鸪
莼	莼
栲	栲
栳	栳
郴	郴
桓	桓
桡	桡
桎	桎
桢	桢
桤	桤
梃	梃
栝	栝
桕	桕
桁	桁
桧	桧
桅	桅
栟	栟
桉	桉
栩	栩
逑	逑
逋	逋
彧	彧
鬲	鬲
豇	豇
酐	酐
逦	逦
厝	厝
孬	孬
砝	砝
砹	砹
砺	砺
砧	砧
砷	砷
砟	砟
砼	砼
砥	砥
砣	砣
剞	剞
砻	砻
轼	轼
轾	轾
辂	辂
鸫	鸫
趸	趸
龀	龀
鸬	鸬
虔	虔
逍	逍
眬	眬
唛	唛
晟	晟
眩	眩
眙	眙
哧	哧
哽	哽
唔	唔
晁	晁
晏	晏
鸮	鸮
趵	趵
趿	趿
畛	畛
蚨	蚨
蚜	蚜
蚍	蚍
蚋	蚋
蚬	蚬
蚝	蚝
蚧	蚧
唢	唢
圄	圄
唣	唣
唏	唏
盎	盎
唑	唑
崂	崂
崃	崃
罡	罡
罟	罟
峪	峪
觊	觊
赅	赅
钰	钰
钲	钲
钴	钴
钵	钵
钹	钹
钺	钺
钽	钽
钼	钼
钿	钿
铀	铀
铂	铂
铄	铄
铆	铆
铈	铈
铉	铉
铊	铊
铋	铋
铌	铌
铍	铍
䥽	䥽
铎	铎
氩	氩
氤	氤
氦	氦
毪	毪
舐	舐
秣	秣
秫	秫
盉	盉
笄	笄
笕	笕
笊	笊
笏	笏
笆	笆
俸	俸
倩	倩
俵	俵
偌	偌
俳	俳
俶	俶
倬	倬
倏	倏
恁	恁
倭	倭
倪	倪
俾	俾
倜	倜
隼	隼
隽	隽
倌	倌
倥	倥
臬	臬
皋	皋
郫	郫
倨	倨
衄	衄
颀	颀
徕	徕
舫	舫
釜	釜
奚	奚
衾	衾
胯	胯
胱	胱
胴	胴
胭	胭
脍	脍
胼	胼
朕	朕
脒	脒
胺	胺
鸱	鸱
玺	玺
鸲	鸲
狷	狷
猁	猁
狳	狳
猃	猃
狺	狺
逖	逖
桀	桀
袅	袅
饽	饽
凇	凇
栾	栾
挛	挛
亳	亳
疳	疳
疴	疴
疸	疸
疽	疽
痈	痈
疱	疱
痂	痂
痉	痉
衮	衮
凋	凋
颃	颃
恣	恣
旆	旆
旄	旄
旃	旃
阃	阃
阄	阄
訚	訚
阆	阆
恙	恙
粑	粑
朔	朔
郸	郸
烜	烜
烨	烨
烩	烩
烊	烊
剡	剡
郯	郯
烬	烬
涑	涑
浯	浯
涞	涞
涟	涟
娑	娑
涅	涅
涠	涠
浞	浞
涓	涓
浥	浥
涔	涔
浜	浜
浠	浠
浣	浣
浚	浚
悚	悚
悭	悭
悝	悝
悒	悒
悌	悌
悛	悛
宸	宸
窈	窈
剜	剜
诹	诹
冢	冢
诼	诼
袒	袒
袢	袢
祯	祯
诿	诿
谀	谀
谂	谂
谄	谄
谇	谇
屐	屐
屙	屙
陬	陬
勐	勐
奘	奘
牂	牂
蚩	蚩
陲	陲
姬	姬
娠	娠
娌	娌
娉	娉
娲	娲
娩	娩
娴	娴
娣	娣
娓	娓
婀	婀
畚	畚
逡	逡
绠	绠
骊	骊
绡	绡
骋	骋
绥	绥
绦	绦
绨	绨
骎	骎
邕	邕
鸶	鸶
彗	彗
耜	耜
焘	焘
舂	舂
琏	琏
琇	琇
麸	麸
揶	揶
埴	埴
埯	埯
捯	捯
掳	掳
掴	掴
埸	埸
埵	埵
赧	赧
埤	埤
捭	捭
逵	逵
埝	埝
堋	堋
堍	堍
掬	掬
鸷	鸷
掖	掖
捽	捽
掊	掊
堉	堉
掸	掸
捩	捩
掮	掮
悫	悫
埭	埭
埽	埽
掇	掇
掼	掼
聃	聃
菁	菁
萁	萁
菘	菘
堇	堇
萘	萘
萋	萋
菽	菽
菖	菖
萜	萜
萸	萸
萑	萑
棻	棻
菔	菔
菟	菟
萏	萏
萃	萃
菏	菏
菹	菹
菪	菪
菅	菅
菀	菀
萦	萦
菰	菰
菡	菡
梵	梵
梿	梿
梏	梏
觋	觋
桴	桴
桷	桷
梓	梓
棁	棁
桫	桫
棂	棂
啬	啬
郾	郾
匮	匮
敕	敕
豉	豉
鄄	鄄
酞	酞
酚	酚
戛	戛
硎	硎
硭	硭
硒	硒
硖	硖
硗	硗
硐	硐
硇	硇
硌	硌
鸸	鸸
瓠	瓠
匏	匏
厩	厩
龚	龚
殒	殒
殓	殓
殍	殍
赉	赉
雩	雩
辄	辄
堑	堑
眭	眭
眦	眦
啧	啧
晡	晡
晤	晤
眺	眺
眵	眵
眸	眸
圊	圊
喏	喏
喵	喵
啉	啉
勖	勖
晞	晞
唵	唵
晗	晗
冕	冕
啭	啭
畦	畦
趺	趺
啮	啮
跄	跄
蚶	蚶
蛄	蛄
蛎	蛎
蛆	蛆
蚰	蚰
蛊	蛊
圉	圉
蚱	蚱
蛉	蛉
蛏	蛏
蚴	蚴
啁	啁
啕	啕
唿	唿
啐	啐
唼	唼
唷	唷
啖	啖
啵	啵
啶	啶
啷	啷
唳	唳
唰	唰
啜	啜
帻	帻
崚	崚
崦	崦
帼	帼
崮	崮
崤	崤
崆	崆
赇	赇
赈	赈
赊	赊
铑	铑
铒	铒
铗	铗
铙	铙
铟	铟
铠	铠
铡	铡
铢	铢
铣	铣
铤	铤
铧	铧
铨	铨
铩	铩
铪	铪
铫	铫
铬	铬
铮	铮
铯	铯
铰	铰
铱	铱
铳	铳
铵	铵
铷	铷
氪	氪
牾	牾
鸹	鸹
秾	秾
逶	逶
笺	笺
筇	筇
笸	笸
笪	笪
笮	笮
笠	笠
笥	笥
笤	笤
笳	笳
笾	笾
笞	笞
偾	偾
偃	偃
偕	偕
偈	偈
傀	傀
偬	偬
偻	偻
皑	皑
皎	皎
鸻	鸻
徜	徜
舸	舸
舻	舻
舴	舴
舷	舷
龛	龛
翎	翎
脬	脬
脘	脘
脲	脲
匐	匐
猗	猗
猡	猡
猞	猞
猝	猝
斛	斛
猕	猕
馗	馗
馃	馃
馄	馄
鸾	鸾
孰	孰
庹	庹
庾	庾
痔	痔
痍	痍
疵	疵
翊	翊
旌	旌
旎	旎
袤	袤
阇	阇
阈	阈
阉	阉
阊	阊
阋	阋
阍	阍
阏	阏
羟	羟
粝	粝
粕	粕
敝	敝
焐	焐
烯	烯
焓	焓
烽	烽
焖	焖
烷	烷
焗	焗
渍	渍
渚	渚
淇	淇
淅	淅
淞	淞
渎	渎
涿	涿
淖	淖
挲	挲
淠	淠
涸	涸
渑	渑
淦	淦
淝	淝
淬	淬
涪	涪
淙	淙
涫	涫
渌	渌
淄	淄
惬	惬
悻	悻
悱	悱
惝	惝
惘	惘
悸	悸
惆	惆
惚	惚
惇	惇
惮	惮
窕	窕
谌	谌
谏	谏
扈	扈
皲	皲
谑	谑
裆	裆
裉	裉
谒	谒
谔	谔
谕	谕
谖	谖
谗	谗
谙	谙
谛	谛
谝	谝
逯	逯
郿	郿
隈	隈
粜	粜
隍	隍
隗	隗
婧	婧
婊	婊
婕	婕
娼	娼
婢	婢
婵	婵
胬	胬
袈	袈
翌	翌
恿	恿
欸	欸
绫	绫
骐	骐
绮	绮
绯	绯
绱	绱
骒	骒
绲	绲
骓	骓
绶	绶
绺	绺
绻	绻
绾	绾
骖	骖
缁	缁
耠	耠
琫	琫
琵	琵
琶	琶
琪	琪
瑛	瑛
琦	琦
琥	琥
琨	琨
靓	靓
琰	琰
琮	琮
琯	琯
琬	琬
琛	琛
琚	琚
辇	辇
鼋	鼋
揳	揳
堞	堞
搽	搽
揸	揸
揠	揠
堙	堙
趄	趄
揖	揖
颉	颉
塄	塄
揿	揿
耋	耋
揄	揄
蛩	蛩
蛰	蛰
塆	塆
摒	摒
揆	揆
掾	掾
聒	聒
葑	葑
葚	葚
靰	靰
靸	靸
葳	葳
葺	葺
葸	葸
萼	萼
葆	葆
葩	葩
葶	葶
蒌	蒌
萱	萱
戟	戟
葭	葭
楮	楮
棼	棼
椟	椟
棹	棹
椤	椤
棰	棰
赍	赍
椋	椋
椁	椁
椪	椪
棣	棣
椐	椐
鹁	鹁
覃	覃
酤	酤
酢	酢
酡	酡
鹂	鹂
厥	厥
殚	殚
殛	殛
雯	雯
雱	雱
辊	辊
辋	辋
椠	椠
辍	辍
辎	辎
斐	斐
睄	睄
睑	睑
睇	睇
睃	睃
戢	戢
喋	喋
嗒	嗒
喃	喃
喱	喱
喹	喹
晷	晷
喈	喈
跖	跖
跗	跗
跞	跞
跚	跚
跎	跎
跏	跏
跆	跆
蛱	蛱
蛲	蛲
蛭	蛭
蛳	蛳
蛐	蛐
蛔	蛔
蛞	蛞
蛴	蛴
蛟	蛟
蛘	蛘
喁	喁
喟	喟
啾	啾
嗖	嗖
喑	喑
嗟	嗟
喽	喽
嗞	嗞
喀	喀
喔	喔
喙	喙
嵘	嵘
嵖	嵖
崴	崴
遄	遄
詈	詈
嵎	嵎
崽	崽
嵬	嵬
嵛	嵛
嵯	嵯
嵝	嵝
嵫	嵫
幄	幄
嵋	嵋
赕	赕
铻	铻
铼	铼
铿	铿
锃	锃
锂	锂
锆	锆
锇	锇
锉	锉
锏	锏
锑	锑
锒	锒
锔	锔
锕	锕
掣	掣
矬	矬
氰	氰
毳	毳
毽	毽
犊	犊
犄	犄
犋	犋
鹄	鹄
犍	犍
嵇	嵇
黍	黍
稃	稃
稂	稂
筚	筚
筵	筵
筌	筌
傣	傣
傈	傈
舄	舄
牍	牍
傥	傥
傧	傧
遑	遑
傩	傩
遁	遁
徨	徨
媭	媭
畲	畲
弑	弑
颌	颌
翕	翕
釉	釉
鹆	鹆
舜	舜
貂	貂
腈	腈
腌	腌
腓	腓
腆	腆
腴	腴
腑	腑
腚	腚
腱	腱
鱿	鱿
鲀	鲀
鲂	鲂
颍	颍
猢	猢
猹	猹
猥	猥
飓	飓
觞	觞
觚	觚
猱	猱
颎	颎
飧	飧
馇	馇
馊	馊
亵	亵
脔	脔
裒	裒
痣	痣
痨	痨
痦	痦
痞	痞
痤	痤
痫	痫
痧	痧
赓	赓
竦	竦
瓿	瓿
啻	啻
颏	颏
鹇	鹇
阑	阑
阒	阒
阕	阕
粞	粞
遒	遒
孳	孳
焯	焯
焜	焜
焙	焙
焱	焱
鹈	鹈
湛	湛
渫	渫
湮	湮
湎	湎
湜	湜
渭	渭
湍	湍
湫	湫
溲	溲
湟	湟
溆	溆
湲	湲
湔	湔
湉	湉
渥	渥
湄	湄
滁	滁
愠	愠
惺	惺
愦	愦
惴	惴
愀	愀
愎	愎
愔	愔
喾	喾
寐	寐
谟	谟
扉	扉
裢	裢
裎	裎
裥	裥
祾	祾
祺	祺
谠	谠
幂	幂
谡	谡
谥	谥
谧	谧
遐	遐
孱	孱
弼	弼
巽	巽
骘	骘
媪	媪
媛	媛
婷	婷
巯	巯
翚	翚
皴	皴
婺	婺
骛	骛
缂	缂
缃	缃
缄	缄
彘	彘
缇	缇
缈	缈
缌	缌
缑	缑
缒	缒
缗	缗
飨	飨
耢	耢
瑚	瑚
瑁	瑁
瑜	瑜
瑗	瑗
瑄	瑄
瑕	瑕
遨	遨
骜	骜
韫	韫
髡	髡
塬	塬
鄢	鄢
趔	趔
趑	趑
摅	摅
摁	摁
蜇	蜇
搋	搋
搪	搪
搐	搐
搛	搛
搠	搠
摈	摈
彀	彀
毂	毂
搦	搦
搡	搡
蓁	蓁
戡	戡
蓍	蓍
鄞	鄞
靳	靳
蓐	蓐
蓦	蓦
鹋	鹋
蒽	蒽
蓓	蓓
蓖	蓖
蓊	蓊
蒯	蒯
蓟	蓟
蓑	蓑
蒿	蒿
蒺	蒺
蓠	蓠
蒟	蒟
蒡	蒡
蒹	蒹
蒴	蒴
蒗	蒗
蓥	蓥
颐	颐
楔	楔
楠	楠
楂	楂
楝	楝
楫	楫
楸	楸
椴	椴
槌	槌
楯	楯
皙	皙
榈	榈
槎	槎
榉	榉
楦	楦
楣	楣
楹	楹
椽	椽
裘	裘
剽	剽
甄	甄
酮	酮
酰	酰
酯	酯
酩	酩
蜃	蜃
碛	碛
碓	碓
硼	硼
碉	碉
碚	碚
碇	碇
碜	碜
鹌	鹌
辏	辏
龃	龃
龅	龅
訾	訾
粲	粲
虞	虞
睚	睚
嗪	嗪
韪	韪
嗷	嗷
嗉	嗉
睨	睨
睢	睢
雎	雎
睥	睥
嘟	嘟
嗑	嗑
嗫	嗫
嗬	嗬
嗔	嗔
嗝	嗝
戥	戥
嗄	嗄
煦	煦
暄	暄
遢	遢
暌	暌
跬	跬
跶	跶
跸	跸
跐	跐
跣	跣
跹	跹
跻	跻
蛸	蛸
蜊	蜊
蜍	蜍
蜉	蜉
蜣	蜣
畹	畹
蛹	蛹
嗣	嗣
嗯	嗯
嗥	嗥
嗲	嗲
嗳	嗳
嗌	嗌
嗍	嗍
嗨	嗨
嗐	嗐
嗤	嗤
嗵	嗵
罨	罨
嵊	嵊
嵩	嵩
嵴	嵴
骰	骰
锗	锗
锛	锛
锜	锜
锝	锝
锞	锞
锟	锟
锢	锢
锨	锨
锩	锩
锭	锭
锱	锱
雉	雉
氲	氲
犏	犏
歃	歃
稞	稞
稗	稗
稔	稔
筠	筠
筢	筢
筮	筮
筲	筲
筱	筱
牒	牒
煲	煲
敫	敫
徭	徭
愆	愆
艄	艄
觎	觎
毹	毹
貊	貊
貅	貅
貉	貉
颔	颔
腠	腠
腩	腩
腼	腼
腭	腭
腧	腧
塍	塍
媵	媵
詹	詹
鲅	鲅
鲆	鲆
鲇	鲇
鲈	鲈
稣	稣
鲋	鲋
鲐	鲐
肄	肄
鹐	鹐
飕	飕
觥	觥
遛	遛
馐	馐
鹑	鹑
亶	亶
瘃	瘃
痱	痱
痼	痼
痿	痿
瘐	瘐
瘁	瘁
瘆	瘆
麂	麂
裔	裔
歆	歆
旒	旒
雍	雍
阖	阖
阗	阗
阙	阙
羧	羧
豢	豢
粳	粳
猷	猷
煳	煳
煜	煜
煨	煨
煅	煅
煊	煊
煸	煸
煺	煺
滟	滟
溱	溱
溘	溘
漭	漭
滢	滢
溥	溥
溧	溧
溽	溽
裟	裟
溻	溻
溷	溷
滗	滗
滫	滫
溴	溴
滏	滏
滃	滃
滦	滦
溏	溏
滂	滂
滓	滓
溟	溟
滪	滪
愫	愫
慑	慑
慊	慊
鲎	鲎
骞	骞
窦	窦
窠	窠
窣	窣
裱	裱
褚	褚
裨	裨
裾	裾
裰	裰
禊	禊
谩	谩
谪	谪
媾	媾
嫫	嫫
媲	媲
嫒	嫒
嫔	嫔
媸	媸
缙	缙
缜	缜
缛	缛
辔	辔
骝	骝
缟	缟
缡	缡
缢	缢
缣	缣
骟	骟
耥	耥
璈	璈
瑶	瑶
瑭	瑭
獒	獒
觏	觏
慝	慝
嫠	嫠
韬	韬
叆	叆
髦	髦
摽	摽
墁	墁
撂	撂
摞	摞
撄	撄
翥	翥
踅	踅
摭	摭
墉	墉
墒	墒
榖	榖
綦	綦
蔫	蔫
蔷	蔷
靺	靺
靼	靼
鞅	鞅
靿	靿
甍	甍
蔸	蔸
蔟	蔟
蔺	蔺
戬	戬
蕖	蕖
蔻	蔻
蓿	蓿
斡	斡
鹕	鹕
蓼	蓼
榛	榛
榧	榧
榻	榻
榫	榫
榭	榭
槔	槔
榱	榱
槁	槁
槟	槟
槠	槠
榷	榷
僰	僰
酽	酽
酶	酶
酹	酹
厮	厮
碡	碡
碴	碴
碣	碣
碲	碲
磋	磋
臧	臧
豨	豨
殡	殡
霆	霆
霁	霁
辕	辕
蜚	蜚
裴	裴
翡	翡
龇	龇
龈	龈
睿	睿
䁖	䁖
睽	睽
嘞	嘞
嘈	嘈
嘌	嘌
嘁	嘁
嘎	嘎
暧	暧
暝	暝
踌	踌
踉	踉
蜞	蜞
蜥	蜥
蜮	蜮
蝈	蝈
蜴	蜴
蜱	蜱
蜩	蜩
蜷	蜷
蜿	蜿
螂	螂
蜢	蜢
嘘	嘘
嘡	嘡
鹗	鹗
嘣	嘣
嘤	嘤
嘚	嘚
嗾	嗾
嘧	嘧
罴	罴
罱	罱
幔	幔
嶂	嶂
幛	幛
赙	赙
罂	罂
骷	骷
骶	骶
鹘	鹘
锲	锲
锴	锴
锶	锶
锷	锷
锸	锸
锵	锵
镁	镁
镂	镂
犒	犒
箐	箐
箦	箦
箧	箧
箍	箍
箸	箸
箬	箬
箅	箅
箪	箪
箔	箔
箜	箜
箢	箢
箓	箓
毓	毓
僖	僖
儆	儆
僳	僳
僭	僭
劁	劁
僮	僮
魃	魃
魆	魆
睾	睾
艋	艋
鄱	鄱
膈	膈
膑	膑
鲑	鲑
鲔	鲔
鲚	鲚
鲛	鲛
鲟	鲟
獐	獐
觫	觫
雒	雒
夤	夤
馑	馑
銮	銮
塾	塾
瘌	瘌
瘊	瘊
瘘	瘘
瘙	瘙
廖	廖
韶	韶
旖	旖
膂	膂
阚	阚
鄯	鄯
鲞	鲞
粿	粿
粼	粼
粽	粽
糁	糁
槊	槊
鹚	鹚
熘	熘
熥	熥
潢	潢
漕	漕
滹	滹
漯	漯
漶	漶
潋	潋
潴	潴
漪	漪
漉	漉
漳	漳
漩	漩
澉	澉
潍	潍
慵	慵
搴	搴
窨	窨
寤	寤
綮	綮
谮	谮
褡	褡
褙	褙
褓	褓
褛	褛
褊	褊
谯	谯
谰	谰
谲	谲
暨	暨
屣	屣
鹛	鹛
嫣	嫣
嫱	嫱
嫖	嫖
嫦	嫦
嫚	嫚
嫘	嫘
嫡	嫡
鼐	鼐
翟	翟
瞀	瞀
鹜	鹜
骠	骠
缥	缥
缦	缦
缧	缧
缨	缨
骢	骢
缪	缪
缫	缫
耦	耦
耧	耧
瑾	瑾
璜	璜
璀	璀
璎	璎
璁	璁
璋	璋
璇	璇
奭	奭
髯	髯
髫	髫
撷	撷
撅	撅
赭	赭
撸	撸
鋆	鋆
撙	撙
撺	撺
墀	墀
聩	聩
觐	觐
鞑	鞑
蕙	蕙
鞒	鞒
蕈	蕈
蕨	蕨
蕤	蕤
蕞	蕞
蕺	蕺
瞢	瞢
蕃	蕃
蕲	蕲
赜	赜
槿	槿
樯	樯
槭	槭
樗	樗
樘	樘
樊	樊
槲	槲
醌	醌
醅	醅
靥	靥
魇	魇
餍	餍
磔	磔
磙	磙
霈	霈
辘	辘
龉	龉
龊	龊
觑	觑
瞌	瞌
瞋	瞋
瞑	瞑
嘭	嘭
噎	噎
噶	噶
颙	颙
暹	暹
噘	噘
踔	踔
踝	踝
踟	踟
踒	踒
踬	踬
踮	踮
踯	踯
踺	踺
踞	踞
蝽	蝽
蝾	蝾
蝻	蝻
蝰	蝰
蝮	蝮
螋	螋
蝓	蝓
蝣	蝣
蝼	蝼
噗	噗
嘬	嘬
颚	颚
噍	噍
噢	噢
噙	噙
噜	噜
噌	噌
噔	噔
颛	颛
幞	幞
幡	幡
嶙	嶙
嶝	嶝
骺	骺
骼	骼
骸	骸
镊	镊
镉	镉
镌	镌
镍	镍
镏	镏
镒	镒
镓	镓
镔	镔
稷	稷
箴	箴
篑	篑
篁	篁
篌	篌
篆	篆
牖	牖
儋	儋
磐	磐
虢	虢
鹞	鹞
膘	膘
滕	滕
鲠	鲠
鲡	鲡
鲢	鲢
鲣	鲣
鲥	鲥
鲧	鲧
鲩	鲩
獗	獗
獠	獠
觯	觯
馓	馓
馔	馔
麾	麾
廛	廛
瘛	瘛
瘼	瘼
瘢	瘢
瘠	瘠
齑	齑
羯	羯
羰	羰
𥻗	𥻗
遴	遴
糌	糌
糍	糍
糅	糅
熜	熜
熵	熵
熠	熠
澍	澍
澌	澌
潸	潸
潦	潦
潲	潲
鋈	鋈
潟	潟
潼	潼
潺	潺
憬	憬
憧	憧
寮	寮
窳	窳
谳	谳
褴	褴
褟	褟
褫	褫
谵	谵
熨	熨
屦	屦
嬉	嬉
勰	勰
戮	戮
蝥	蝥
缬	缬
缮	缮
缯	缯
骣	骣
畿	畿
耩	耩
耨	耨
耪	耪
璞	璞
璟	璟
靛	靛
璠	璠
璘	璘
聱	聱
螯	螯
髻	髻
髭	髭
髹	髹
擀	擀
熹	熹
甏	甏
擞	擞
縠	縠
磬	磬
颞	颞
蕻	蕻
鞘	鞘
颟	颟
薤	薤
薨	薨
檠	檠
薏	薏
薮	薮
薜	薜
薅	薅
樾	樾
橛	橛
橇	橇
樵	樵
檎	檎
橹	橹
樽	樽
樨	樨
橼	橼
墼	墼
橐	橐
翮	翮
醛	醛
醐	醐
醍	醍
醚	醚
磲	磲
赝	赝
飙	飙
殪	殪
霖	霖
霏	霏
霓	霓
錾	錾
辚	辚
臻	臻
遽	遽
氅	氅
瞟	瞟
瞠	瞠
瞰	瞰
嚄	嚄
嚆	嚆
噤	噤
暾	暾
蹀	蹀
踹	踹
踵	踵
踽	踽
蹉	蹉
蹁	蹁
螨	螨
蟒	蟒
螈	螈
螅	螅
螭	螭
螠	螠
螟	螟
噱	噱
噬	噬
噫	噫
噻	噻
噼	噼
罹	罹
圜	圜
䦃	䦃
镖	镖
镗	镗
镘	镘
镚	镚
镛	镛
镝	镝
镞	镞
镠	镠
氇	氇
氆	氆
憩	憩
穑	穑
篝	篝
篥	篥
篦	篦
篪	篪
篙	篙
盥	盥
劓	劓
翱	翱
魉	魉
魈	魈
徼	徼
歙	歙
膳	膳
膦	膦
膙	膙
鲮	鲮
鲱	鲱
鲲	鲲
鲳	鲳
鲴	鲴
鲵	鲵
鲷	鲷
鲻	鲻
獴	獴
獭	獭
獬	獬
邂	邂
鹧	鹧
廨	廨
赟	赟
瘰	瘰
廪	廪
瘿	瘿
瘵	瘵
瘴	瘴
癃	癃
瘳	瘳
斓	斓
麇	麇
麈	麈
嬴	嬴
壅	壅
羲	羲
糗	糗
瞥	瞥
甑	甑
燎	燎
燠	燠
燔	燔
燧	燧
濑	濑
濉	濉
潞	潞
澧	澧
澹	澹
澥	澥
澶	澶
濂	濂
褰	褰
寰	寰
窸	窸
褶	褶
禧	禧
嬖	嬖
犟	犟
隰	隰
嬗	嬗
颡	颡
缱	缱
缲	缲
缳	缳
璨	璨
璩	璩
璐	璐
璪	璪
螫	螫
擤	擤
壕	壕
觳	觳
罄	罄
擢	擢
薹	薹
鞡	鞡
鞬	鞬
薷	薷
薰	薰
藓	藓
藁	藁
檄	檄
檩	檩
懋	懋
醢	醢
翳	翳
礅	礅
磴	磴
鹩	鹩
龋	龋
龌	龌
豳	豳
壑	壑
黻	黻
嚏	嚏
嚅	嚅
蹑	蹑
蹒	蹒
蹊	蹊
蟥	蟥
螬	螬
螵	螵
疃	疃
螳	螳
蟑	蟑
嚓	嚓
羁	羁
罽	罽
罾	罾
嶷	嶷
黜	黜
黝	黝
髁	髁
髀	髀
镡	镡
镢	镢
镣	镣
镦	镦
镧	镧
镩	镩
镪	镪
镫	镫
罅	罅
黏	黏
簌	簌
篾	篾
篼	篼
簖	簖
簋	簋
鼢	鼢
黛	黛
儡	儡
鹪	鹪
鼾	鼾
皤	皤
魍	魍
龠	龠
繇	繇
貘	貘
邈	邈
貔	貔
臌	臌
膻	膻
臆	臆
臃	臃
鲼	鲼
鲽	鲽
鳀	鳀
鳃	鳃
鳅	鳅
鳇	鳇
鳊	鳊
螽	螽
燮	燮
鹫	鹫
襄	襄
糜	糜
縻	縻
膺	膺
癍	癍
麋	麋
懑	懑
濡	濡
濮	濮
濞	濞
濠	濠
濯	濯
蹇	蹇
謇	謇
邃	邃
襁	襁
檗	檗
擘	擘
孺	孺
隳	隳
嬷	嬷
蟊	蟊
鹬	鹬
鍪	鍪
鏊	鏊
鳌	鳌
鬈	鬈
鬃	鬃
瞽	瞽
鞯	鞯
鞨	鞨
鞫	鞫
鞧	鞧
鞣	鞣
藜	藜
藠	藠
藩	藩
醪	醪
蹙	蹙
礓	礓
燹	燹
餮	餮
瞿	瞿
曛	曛
颢	颢
曜	曜
躇	躇
蹚	蹚
鹭	鹭
蟛	蟛
蟪	蟪
蟠	蟠
蟮	蟮
鹮	鹮
黠	黠
黟	黟
髅	髅
髂	髂
镬	镬
镭	镭
镯	镯
馥	馥
簟	簟
簪	簪
鼬	鼬
雠	雠
艟	艟
鳎	鳎
鳏	鳏
鳐	鳐
癞	癞
癔	癔
癜	癜
癖	癖
糨	糨
蹩	蹩
鎏	鎏
懵	懵
彝	彝
邋	邋
鬏	鬏
攉	攉
攒	攒
鞲	鞲
鞴	鞴
藿	藿
蘧	蘧
蘅	蘅
麓	麓
醮	醮
醯	醯
酃	酃
霪	霪
霭	霭
霨	霨
黼	黼
嚯	嚯
蹰	蹰
蹶	蹶
蹽	蹽
蹼	蹼
蹴	蹴
蹾	蹾
蹿	蹿
蠖	蠖
蠓	蠓
蟾	蟾
蠊	蠊
黢	黢
髋	髋
髌	髌
镲	镲
籀	籀
籁	籁
齁	齁
魑	魑
艨	艨
鳓	鳓
鳔	鳔
鳕	鳕
鳗	鳗
鳙	鳙
麒	麒
鏖	鏖
羸	羸
㸆	㸆
瀚	瀚
瀣	瀣
瀛	瀛
襦	襦
谶	谶
襞	襞
骥	骥
缵	缵
瓒	瓒
攘	攘
蘩	蘩
蘖	蘖
醴	醴
霰	霰
酆	酆
矍	矍
曦	曦
躅	躅
鼍	鼍
巉	巉
黩	黩
黥	黥
黪	黪
镳	镳
镴	镴
黧	黧
纂	纂
璺	璺
鼯	鼯
臜	臜
鳜	鳜
鳝	鳝
鳟	鳟
獾	獾
孀	孀
骧	骧
瓘	瓘
鼙	鼙
醺	醺
礴	礴
颦	颦
曩	曩
鳢	鳢
癫	癫
麝	麝
夔	夔
爝	爝
灏	灏
禳	禳
鐾	鐾
羼	羼
蠡	蠡
耱	耱
懿	懿
蘸	蘸
鹳	鹳
霾	霾
氍	氍
饕	饕
躐	躐
髑	髑
镵	镵
穰	穰
饔	饔
鬻	鬻
鬟	鬟
趱	趱
攫	攫
攥	攥
颧	颧
躜	躜
鼹	鼹
癯	癯
麟	麟
蠲	蠲
蠹	蠹
躞	躞
衢	衢
鑫	鑫
灞	灞
襻	襻
纛	纛
鬣	鬣
攮	攮
囔	囔
馕	馕
戆	戆
爨	爨
齉	齉
亍	亍
尢	尢
彳	彳
卬	卬
殳	殳
𠙶	𠙶
毌	毌
邘	邘
戋	戋
圢	圢
氕	氕
伋	伋
冮	冮
氿	氿
汈	汈
忉	忉
宄	宄
𬣙	𬣙
讱	讱
圲	圲
圫	圫
芏	芏
芃	芃
朳	朳
朸	朸
𨙸	𨙸
吖	吖
屼	屼
屾	屾
辿	辿
钆	钆
仳	仳
伣	伣
伈	伈
癿	癿
甪	甪
邠	邠
犴	犴
冱	冱
邡	邡
闫	闫
𬇕	𬇕
汋	汋
䜣	䜣
讻	讻
𬣞	𬣞
孖	孖
𬘓	𬘓
纩	纩
玒	玒
玓	玓
玘	玘
玚	玚
刬	刬
𫭟	𫭟
坜	坜
坉	坉
扽	扽
𫭢	𫭢
坋	坋
扺	扺
㧑	㧑
毐	毐
芰	芰
芣	芣
苊	苊
苉	苉
芘	芘
芴	芴
芠	芠
𫇭	𫇭
芤	芤
杕	杕
杙	杙
杄	杄
杧	杧
杩	杩
尪	尪
尨	尨
轪	轪
𫐄	𫐄
坒	坒
芈	芈
旴	旴
旵	旵
呙	呙
㕮	㕮
岍	岍
𫵷	𫵷
岠	岠
岜	岜
呇	呇
冏	冏
觃	觃
岙	岙
伾	伾
㑇	㑇
伭	伭
佖	佖
伲	伲
佁	佁
飏	飏
狃	狃
闶	闶
汧	汧
汫	汫
𣲘	𣲘
𣲗	𣲗
沄	沄
沘	沘
𬇙	𬇙
汭	汭
㳇	㳇
沇	沇
忮	忮
忳	忳
忺	忺
𬣡	𬣡
祃	祃
诇	诇
邲	邲
诎	诎
诐	诐
屃	屃
𫸩	𫸩
岊	岊
阽	阽
䢺	䢺
阼	阼
妧	妧
妘	妘
𨚕	𨚕
纮	纮
驲	驲
𫘜	𫘜
纻	纻
𬘘	𬘘
𫘝	𫘝
纼	纼
玤	玤
玞	玞
玱	玱
玟	玟
邽	邽
邿	邿
坥	坥
坰	坰
坬	坬
坽	坽
弆	弆
耵	耵
䢼	䢼
𦭜	𦭜
茋	茋
苾	苾
苠	苠
枅	枅
㭎	㭎
枘	枘
枍	枍
矼	矼
矻	矻
匼	匼
𬨂	𬨂
𬀩	𬀩
𬀪	𬀪
旿	旿
昄	昄
昒	昒
昈	昈
咉	咉
咇	咇
咍	咍
岵	岵
岽	岽
岨	岨
岞	岞
峂	峂
㟃	㟃
囷	囷
𬬩	𬬩
钐	钐
钔	钔
钖	钖
牥	牥
佴	佴
垈	垈
侁	侁
侹	侹
佸	佸
佺	佺
隹	隹
㑊	㑊
侂	侂
佽	佽
侘	侘
郈	郈
舠	舠
郐	郐
郃	郃
攽	攽
肭	肭
肸	肸
肷	肷
狉	狉
狝	狝
饳	饳
忞	忞
於	於
炌	炌
炆	炆
泙	泙
沺	沺
泂	泂
泜	泜
泃	泃
泇	泇
怊	怊
峃	峃
穸	穸
祋	祋
祊	祊
𫍣	𫍣
𬣳	𬣳
𬩽	𬩽
鸤	鸤
弢	弢
弨	弨
陑	陑
𬮿	𬮿
陎	陎
𬯀	𬯀
卺	卺
乸	乸
妭	妭
姈	姈
𫰛	𫰛
迳	迳
叕	叕
𬳵	𬳵
驵	驵
𬳶	𬳶
䌹	䌹
驺	驺
𫠊	𫠊
绋	绋
绐	绐
砉	砉
耔	耔
㛃	㛃
玶	玶
珇	珇
珅	珅
𬍛	𬍛
珋	珋
玹	玹
珌	珌
玿	玿
韨	韨
垚	垚
垯	垯
垙	垙
垲	垲
埏	埏
垍	垍
耇	耇
鿍	鿍
垎	垎
垴	垴
垟	垟
垞	垞
挓	挓
垵	垵
垏	垏
拶	拶
荖	荖
荁	荁
荙	荙
荛	荛
茈	茈
茽	茽
荄	荄
茺	茺
𬜬	𬜬
荓	荓
茳	茳
𦰡	𦰡
茛	茛
荭	荭
㭕	㭕
柷	柷
柃	柃
柊	柊
枹	枹
栐	栐
柖	柖
郚	郚
剅	剅
䴓	䴓
厖	厖
砆	砆
砑	砑
砄	砄
耏	耏
奓	奓
䶮	䶮
轵	轵
轷	轷
轹	轹
轺	轺
昺	昺
𪾢	𪾢
昽	昽
盷	盷
咡	咡
咺	咺
昳	昳
昣	昣
哒	哒
昤	昤
昫	昫
昡	昡
咥	咥
昪	昪
虷	虷
虸	虸
哃	哃
峘	峘
峛	峛
𪨰	𪨰
峗	峗
峧	峧
帡	帡
钘	钘
𫓧	𫓧
钜	钜
𬬮	𬬮
𬬱	𬬱
𬬭	𬬭
钪	钪
钬	钬
钭	钭
矧	矧
秬	秬
俫	俫
舁	舁
俜	俜
俙	俙
俍	俍
垕	垕
衎	衎
舣	舣
弇	弇
侴	侴
鸧	鸧
䏡	䏡
胠	胠
𦙶	𦙶
胈	胈
胩	胩
胣	胣
朏	朏
飐	飐
訄	訄
饻	饻
庤	庤
疢	疢
炣	炣
炟	炟
㶲	㶲
洭	洭
洘	洘
洓	洓
洿	洿
㳚	㳚
泚	泚
浈	浈
浉	浉
洸	洸
洑	洑
洢	洢
洈	洈
洚	洚
洺	洺
洨	洨
浐	浐
㳘	㳘
洴	洴
洣	洣
恔	恔
宬	宬
窀	窀
扂	扂
袆	袆
祏	祏
祐	祐
陧	陧
娀	娀
姞	姞
姱	姱
姤	姤
姶	姶
姽	姽
枲	枲
绖	绖
骃	骃
𬘡	𬘡
𬳽	𬳽
𬘩	𬘩
𫄧	𫄧
彖	彖
骉	骉
恝	恝
珪	珪
珛	珛
珹	珹
琊	琊
玼	玼
珖	珖
𪟝	𪟝
珽	珽
珦	珦
珫	珫
珒	珒
𬍤	𬍤
珢	珢
珕	珕
珝	珝
𫭼	𫭼
埗	埗
垾	垾
垺	垺
埆	埆
垿	垿
埌	埌
埇	埇
莰	莰
茝	茝
𬜯	𬜯
鄀	鄀
莶	莶
莝	莝
䓖	䓖
莙	莙
栻	栻
桠	桠
𬂩	𬂩
桄	桄
梠	梠
栴	栴
梴	梴
栒	栒
酎	酎
酏	酏
𫠆	𫠆
砵	砵
砠	砠
砫	砫
砬	砬
硁	硁
恧	恧
翃	翃
郪	郪
𨐈	𨐈
辀	辀
辁	辁
𬌗	𬌗
剕	剕
赀	赀
哢	哢
晅	晅
晊	晊
唝	唝
哳	哳
哱	哱
冔	冔
晔	晔
晐	晐
晖	晖
畖	畖
蚄	蚄
蚆	蚆
𫑡	𫑡
帱	帱
崁	崁
峿	峿
𪨶	𪨶
崄	崄
帨	帨
崀	崀
赆	赆
𬬸	𬬸
钷	钷
𬬻	𬬻
𬬹	𬬹
𬬿	𬬿
𬭁	𬭁
眚	眚
甡	甡
笫	笫
倻	倻
倴	倴
倮	倮
倕	倕
倞	倞
𫢸	𫢸
倓	倓
倧	倧
衃	衃
虒	虒
舭	舭
舯	舯
舥	舥
瓞	瓞
鬯	鬯
鸰	鸰
脎	脎
朓	朓
胲	胲
虓	虓
鱽	鱽
狴	狴
峱	峱
狻	狻
眢	眢
𫗧	𫗧
勍	勍
痄	痄
疰	疰
痃	痃
竘	竘
羖	羖
羓	羓
桊	桊
敉	敉
烠	烠
烔	烔
烶	烶
烻	烻
𬊈	𬊈
涍	涍
浡	浡
浭	浭
浬	浬
涄	涄
涢	涢
涐	涐
浰	浰
浟	浟
浛	浛
浼	浼
浲	浲
涘	涘
悈	悈
悃	悃
悢	悢
𬒈	𬒈
宧	宧
窅	窅
窊	窊
窎	窎
扅	扅
扆	扆
袪	袪
袗	袗
袯	袯
祧	祧
隺	隺
堲	堲
疍	疍
𨺙	𨺙
陴	陴
烝	烝
砮	砮
㛚	㛚
哿	哿
翀	翀
翂	翂
剟	剟
𬳿	𬳿
𫄨	𫄨
绤	绤
骍	骍
𬘫	𬘫
䂮	䂮
琎	琎
珸	珸
珵	珵
琄	琄
琈	琈
琀	琀
珺	珺
掭	掭
堎	堎
堐	堐
埼	埼
掎	掎
埫	埫
堌	堌
晢	晢
𫮃	𫮃
掞	掞
埪	埪
壸	壸
㙍	㙍
聍	聍
菝	菝
萚	萚
菥	菥
莿	莿
䓫	䓫
勚	勚
䓬	䓬
萆	萆
菂	菂
菍	菍
菼	菼
萣	萣
䓨	䓨
䓛	䓛
梼	梼
梽	梽
桲	桲
梾	梾
桯	桯
梣	梣
梌	梌
桹	桹
敔	敔
厣	厣
硔	硔
鿎	鿎
硙	硙
硚	硚
硊	硊
硍	硍
勔	勔
䴕	䴕
龁	龁
逴	逴
唪	唪
啫	啫
翈	翈
㫰	㫰
晙	晙
畤	畤
𬱖	𬱖
趼	趼
跂	跂
蛃	蛃
蚲	蚲
𬟽	𬟽
蚺	蚺
啴	啴
䎃	䎃
崧	崧
崟	崟
崞	崞
崒	崒
崌	崌
崡	崡
铏	铏
𫓯	𫓯
𫟹	𫟹
铕	铕
𫟼	𫟼
铖	铖
铘	铘
铚	铚
铞	铞
铥	铥
铴	铴
牻	牻
牿	牿
稆	稆
笱	笱
笯	笯
偰	偰
偡	偡
鸺	鸺
偭	偭
偲	偲
偁	偁
㿠	㿠
鄅	鄅
偓	偓
徛	徛
衒	衒
舳	舳
舲	舲
鸼	鸼
悆	悆
鄃	鄃
瓻	瓻
䝙	䝙
脶	脶
脞	脞
脟	脟
䏲	䏲
鱾	鱾
猇	猇
猊	猊
猄	猄
觖	觖
𠅤	𠅤
庱	庱
庼	庼
庳	庳
痓	痓
䴔	䴔
竫	竫
阌	阌
羝	羝
羕	羕
焆	焆
烺	烺
焌	焌
淏	淏
𬇹	𬇹
淟	淟
淜	淜
淴	淴
淯	淯
湴	湴
涴	涴
𬍡	𬍡
㥄	㥄
惛	惛
惔	惔
悰	悰
惙	惙
寁	寁
逭	逭
𬤇	𬤇
𫍯	𫍯
袼	袼
裈	裈
祲	祲
𬤊	𬤊
𫍲	𫍲
谞	谞
艴	艴
弸	弸
弶	弶
𬯎	𬯎
隃	隃
婞	婞
娵	娵
婼	婼
媖	媖
婳	婳
婍	婍
婌	婌
婫	婫
婤	婤
婘	婘
婠	婠
𬘬	𬘬
𬘭	𬘭
𬴂	𬴂
𫘦	𫘦
绹	绹
𫟅	𫟅
𬘯	𬘯
骕	骕
𫘧	𫘧
珷	珷
琲	琲
琡	琡
琟	琟
琔	琔
琭	琭
堾	堾
堼	堼
揕	揕
㙘	㙘
堧	堧
堨	堨
塅	塅
堠	堠
絷	絷
𪣻	𪣻
𡎚	𡎚
葜	葜
惎	惎
萳	萳
葙	葙
靬	靬
葴	葴
蒇	蒇
蒈	蒈
鄚	鄚
蒉	蒉
蓇	蓇
萩	萩
葰	葰
葎	葎
鄑	鄑
蒎	蒎
葖	葖
蒄	蒄
萹	萹
棤	棤
棽	棽
棫	棫
椓	椓
椑	椑
𬃊	𬃊
鹀	鹀
椆	椆
棓	棓
棬	棬
棪	棪
楗	楗
𬷕	𬷕
酦	酦
觌	觌
奡	奡
皕	皕
硪	硪
欹	欹
詟	詟
𫐐	𫐐
辌	辌
棐	棐
龂	龂
𬹼	𬹼
黹	黹
牚	牚
睎	睎
晫	晫
晪	晪
晱	晱
𧿹	𧿹
蛑	蛑
畯	畯
斝	斝
喤	喤
崶	崶
嵁	嵁
𫶇	𫶇
崾	崾
嵅	嵅
崿	崿
嵚	嵚
翙	翙
𫖮	𫖮
圌	圌
圐	圐
赑	赑
赒	赒
鿏	鿏
铹	铹
𬭊	𬭊
铽	铽
𨱇	𨱇
𫓶	𫓶
锊	锊
锍	锍
锎	锎
𬭎	𬭎
锓	锓
颋	颋
稌	稌
筀	筀
筘	筘
筜	筜
筥	筥
筅	筅
傃	傃
傉	傉
翛	翛
傒	傒
傕	傕
舾	舾
畬	畬
𫖯	𫖯
脿	脿
腘	腘
䐃	䐃
腙	腙
腒	腒
𬱟	𬱟
鲃	鲃
猰	猰
𫛭	𫛭
猯	猯
㺄	㺄
馉	馉
凓	凓
鄗	鄗
𫷷	𫷷
廋	廋
廆	廆
鄌	鄌
粢	粢
遆	遆
旐	旐
𬮱	𬮱
焞	焞
𬊤	𬊤
欻	欻
𣸣	𣸣
溚	溚
溁	溁
湝	湝
渰	渰
湓	湓
㴔	㴔
渟	渟
溠	溠
渼	渼
溇	溇
湣	湣
湑	湑
溞	溞
愐	愐
愃	愃
敩	敩
棨	棨
扊	扊
裣	裣
祼	祼
婻	婻
媆	媆
媞	媞
㛹	㛹
媓	媓
媂	媂
媄	媄
毵	毵
矞	矞
𬴃	𬴃
𫘨	𫘨
缊	缊
缐	缐
骙	骙
瑃	瑃
瑓	瑓
瑅	瑅
瑆	瑆
䴖	䴖
瑖	瑖
瑝	瑝
瑔	瑔
瑀	瑀
𤧛	𤧛
瑳	瑳
瑂	瑂
嶅	嶅
瑑	瑑
遘	遘
髢	髢
塥	塥
堽	堽
赪	赪
摛	摛
塝	塝
搒	搒
搌	搌
蒱	蒱
蒨	蒨
蓏	蓏
蔀	蔀
蓢	蓢
蓂	蓂
蒻	蒻
蓣	蓣
椹	椹
楪	楪
榃	榃
榅	榅
楒	楒
楞	楞
楩	楩
榇	榇
椸	椸
楙	楙
歅	歅
𬪩	𬪩
碃	碃
碏	碏
𬒔	𬒔
碈	碈
䃅	䃅
硿	硿
鄠	鄠
辒	辒
𬨎	𬨎
𫐓	𫐓
龆	龆
觜	觜
䣘	䣘
暕	暕
鹍	鹍
𫫇	𫫇
㬊	㬊
暅	暅
跱	跱
蜐	蜐
蜎	蜎
嵲	嵲
赗	赗
骱	骱
锖	锖
𫓹	𫓹
锘	锘
锳	锳
锧	锧
锪	锪
𬭚	𬭚
锫	锫
锬	锬
𬭛	𬭛
稑	稑
稙	稙
䅟	䅟
𬕂	𬕂
筻	筻
筼	筼
筶	筶
筤	筤
傺	傺
鹎	鹎
僇	僇
艅	艅
艉	艉
谼	谼
貆	貆
腽	腽
腨	腨
腯	腯
鲉	鲉
鲊	鲊
鲌	鲌
䲟	䲟
𬶋	𬶋
𬶍	𬶍
鲏	鲏
雊	雊
猺	猺
飔	飔
觟	觟
𦝼	𦝼
馌	馌
裛	裛
廒	廒
瘀	瘀
瘅	瘅
鄘	鄘
鹒	鹒
鄜	鄜
麀	麀
鄣	鄣
阘	阘
𫔶	𫔶
煁	煁
煃	煃
煴	煴
煋	煋
煟	煟
煓	煓
滠	滠
溍	溍
溹	溹
滆	滆
滉	滉
溦	溦
溵	溵
漷	漷
滧	滧
滘	滘
滍	滍
愭	愭
慥	慥
慆	慆
塱	塱
𫌀	𫌀
裼	裼
禋	禋
禔	禔
禘	禘
禒	禒
谫	谫
鹔	鹔
𫖳	𫖳
愍	愍
嫄	嫄
媱	媱
戤	戤
勠	勠
戣	戣
𫘪	𫘪
𫘬	𫘬
缞	缞
耤	耤
瑧	瑧
𫞩	𫞩
瑨	瑨
瑱	瑱
瑷	瑷
瑢	瑢
斠	斠
摏	摏
墕	墕
墈	墈
墐	墐
墘	墘
摴	摴
銎	銎
𡐓	𡐓
墚	墚
撖	撖
𪤗	𪤗
靽	靽
鞁	鞁
蔌	蔌
蔈	蔈
蓰	蓰
蔹	蔹
蔊	蔊
嘏	嘏
榰	榰
榑	榑
槚	槚
𣗋	𣗋
槜	槜
榍	榍
疐	疐
𬸘	𬸘
酺	酺
酾	酾
酲	酲
酴	酴
碶	碶
䃎	䃎
𬒗	𬒗
碨	碨
𥔲	𥔲
碹	碹
碥	碥
劂	劂
𫚖	𫚖
䴗	䴗
瞍	瞍
鹖	鹖
㬎	㬎
跽	跽
蜾	蜾
幖	幖
嶍	嶍
圙	圙
𨱏	𨱏
锺	锺
锼	锼
锽	锽
𬭤	𬭤
锾	锾
锿	锿
镃	镃
镄	镄
镅	镅
馝	馝
鹙	鹙
箨	箨
箖	箖
僬	僬
僦	僦
僔	僔
僎	僎
槃	槃
㙦	㙦
鲒	鲒
鲕	鲕
𫚕	𫚕
鲖	鲖
鲗	鲗
鲘	鲘
鲙	鲙
𬶐	𬶐
𬶏	𬶏
𩽾	𩽾
夐	夐
獍	獍
飗	飗
𬸚	𬸚
凘	凘
廑	廑
廙	廙
瘗	瘗
瘥	瘥
瘕	瘕
鲝	鲝
鄫	鄫
熇	熇
漹	漹
漖	漖
潆	潆
漤	漤
潩	潩
漼	漼
漴	漴
㽏	㽏
漈	漈
漋	漋
漻	漻
慬	慬
窬	窬
窭	窭
㮾	㮾
𬤝	𬤝
褕	褕
禛	禛
禚	禚
隩	隩
嫕	嫕
嫭	嫭
嫜	嫜
嫪	嫪
𬙂	𬙂
㻬	㻬
麹	麹
璆	璆
漦	漦
叇	叇
墣	墣
墦	墦
墡	墡
劐	劐
薁	薁
蕰	蕰
蔃	蔃
鼒	鼒
槱	槱
鹝	鹝
磏	磏
磉	磉
殣	殣
慭	慭
霅	霅
暵	暵
暲	暲
暶	暶
踦	踦
踣	踣
䗖	䗖
蝘	蝘
蝲	蝲
蝤	蝤
噇	噇
噂	噂
噀	噀
罶	罶
嶲	嶲
嶓	嶓
㠇	㠇
嶟	嶟
嶒	嶒
镆	镆
镈	镈
镋	镋
镎	镎
𬭩	𬭩
镕	镕
稹	稹
儇	儇
皞	皞
皛	皛
䴘	䴘
艎	艎
艏	艏
鹟	鹟
𩾃	𩾃
鲦	鲦
鲪	鲪
鲬	鲬
橥	橥
觭	觭
鹠	鹠
鹡	鹡
糇	糇
糈	糈
翦	翦
鹢	鹢
鹣	鹣
熛	熛
潖	潖
潵	潵
㵐	㵐
澛	澛
瑬	瑬
潽	潽
潾	潾
潏	潏
憭	憭
憕	憕
𬸣	𬸣
戭	戭
褯	褯
禤	禤
𫍽	𫍽
嫽	嫽
遹	遹
𬴊	𬴊
璥	璥
璲	璲
璒	璒
憙	憙
擐	擐
鄹	鄹
薳	薳
鞔	鞔
黇	黇
𬞟	𬞟
蕗	蕗
薢	薢
蕹	蕹
橞	橞
橑	橑
橦	橦
醑	醑
觱	觱
磡	磡
𥕢	𥕢
磜	磜
豮	豮
𫟦	𫟦
𬺈	𬺈
𫠜	𫠜
鹾	鹾
虤	虤
暿	暿
曌	曌
曈	曈
㬚	㬚
蹅	蹅
踶	踶
䗛	䗛
螗	螗
疁	疁
㠓	㠓
幪	幪
𪩘	𪩘
嶦	嶦
𬭬	𬭬
𨱑	𨱑
𬭯	𬭯
馞	馞
穄	穄
篚	篚
篯	篯
簉	簉
鼽	鼽
衠	衠
盦	盦
螣	螣
縢	縢
鲭	鲭
鲯	鲯
鲰	鲰
鲺	鲺
鲹	鲹
𫗴	𫗴
亸	亸
癀	癀
瘭	瘭
𬸦	𬸦
羱	羱
糒	糒
燋	燋
熻	熻
燊	燊
燚	燚
燏	燏
濩	濩
濋	濋
澪	澪
澽	澽
澴	澴
澭	澭
澼	澼
憷	憷
憺	憺
懔	懔
黉	黉
嬛	嬛
鹨	鹨
翯	翯
𫄷	𫄷
璱	璱
𤩽	𤩽
璬	璬
璮	璮
髽	髽
擿	擿
薿	薿
薸	薸
檑	檑
櫆	櫆
檞	檞
醨	醨
繄	繄
磹	磹
磻	磻
瞫	瞫
瞵	瞵
蹐	蹐
蟏	蟏
㘎	㘎
𬭳	𬭳
镤	镤
𬭶	𬭶
𫔍	𫔍
镥	镥
镨	镨
𬭸	𬭸
𨱔	𨱔
𬭼	𬭼
𫔎	𫔎
矰	矰
穙	穙
穜	穜
穟	穟
簕	簕
簃	簃
簏	簏
儦	儦
魋	魋
斶	斶
艚	艚
𬸪	𬸪
䲠	䲠
𬶟	𬶟
鲾	鲾
𬶠	𬶠
鲿	鲿
鳁	鳁
鳂	鳂
鳈	鳈
鳉	鳉
獯	獯
䗪	䗪
馘	馘
襕	襕
襚	襚
𬶨	𬶨
螱	螱
甓	甓
嬬	嬬
嬥	嬥
𦈡	𦈡
𫄸	𫄸
瓀	瓀
鬶	鬶
爇	爇
鞳	鞳
鞮	鞮
𬟁	𬟁
藟	藟
藦	藦
藨	藨
鹲	鹲
檫	檫
黡	黡
礞	礞
礌	礌
𥖨	𥖨
蹢	蹢
蹜	蹜
蟫	蟫
䗴	䗴
嚚	嚚
髃	髃
镮	镮
镱	镱
酂	酂
馧	馧
簠	簠
簝	簝
簰	簰
鼫	鼫
鼩	鼩
皦	皦
臑	臑
䲢	䲢
鳑	鳑
鳒	鳒
鹱	鹱
鹯	鹯
癗	癗
𦒍	𦒍
旞	旞
翷	翷
冁	冁
䎖	䎖
瀔	瀔
瀍	瀍
瀌	瀌
襜	襜
䴙	䴙
𬙊	𬙊
嚭	嚭
㰀	㰀
鬷	鬷
醭	醭
蹯	蹯
蠋	蠋
翾	翾
鳘	鳘
儳	儳
儴	儴
鼗	鼗
𬶭	𬶭
𩾌	𩾌
鳚	鳚
鳛	鳛
麑	麑
麖	麖
蠃	蠃
彟	彟
嬿	嬿
鬒	鬒
蘘	蘘
欂	欂
醵	醵
颥	颥
甗	甗
𨟠	𨟠
巇	巇
酅	酅
髎	髎
犨	犨
𬶮	𬶮
𨭉	𨭉
㸌	㸌
爔	爔
瀱	瀱
瀹	瀹
瀼	瀼
瀵	瀵
襫	襫
孅	孅
骦	骦
𬙋	𬙋
耰	耰
𤫉	𤫉
瓖	瓖
鬘	鬘
趯	趯
𬺓	𬺓
罍	罍
鼱	鼱
鳠	鳠
鳡	鳡
鳣	鳣
爟	爟
爚	爚
灈	灈
韂	韂
糵	糵
蘼	蘼
礵	礵
鹴	鹴
躔	躔
皭	皭
鳤	鳤
亹	亹
籥	籥
鼷	鼷
𫚭	𫚭
玃	玃
醾	醾
齇	齇
觿	觿
蠼	蠼
